3 5 35 52 83 89 104 105 109 110 116 129 133 154 157 168 179 183 193 243 251 259 270 277 280 287 291 293 298 317 325 331 335 347 349 351 358 365 372 375 378 403 408 421 423 438 463 472 485 495 515 529 530 534 549 580 582 585 593 595 599 603 620 630 632 637 640 641 680 682 683 688 700 708 727 742 759 764 771 772
14 28 29 36 46 48 53 56 60 63 64 70 73 74 78 96 99 101 102 106 107 113 121 131 135 138 140 146 151 155 163 164 167 174 182 190 195 200 212 214 216 233 238 245 252 254 260 262 263 268 279 282 284 304 314 324 327 332 336 344 361 363 366 380 397 406 407 409 415 428 429 434 441 442 453 454 459 466 473 478 479 487 497 500 502 508 511 513 523 525 531 544 553 558 570 571 572 573 579 581 587 600 608 612 616 617 622 625 634 643 647 649 660 666 675 685 699 701 706 709 715 721 722 724 732 736 743 747 752 755 756 768 770 776
7 11 16 26 27 34 37 43 79 85 87 88 90 115 130 147 169 170 176 178 180 187 198 211 215 218 224 227 241 255 264 281 283 288 289 305 308 312 313 315 320 334 339 350 362 367 371 373 377 381 385 388 389 395 396 398 404 405 410 416 431 433 439 469 471 488 489 490 491 516 517 521 522 541 545 556 557 560 566 567 575 576 586 594 604 609 610 613 615 639 648 653 654 656 659 663 668 672 686 704 714 720 731 753 760 761 763 767
12 17 23 24 30 31 39 42 47 57 67 68 69 72 77 84 93 97 112 118 120 126 143 144 145 148 153 159 165 166 172 175 177 184 186 191 194 197 207 213 217 239 246 248 273 278 286 299 301 307 310 316 330 333 337 338 340 343 348 355 356 360 364 368 370 379 383 384 392 400 402 411 413 420 424 425 427 432 440 443 446 449 455 460 465 470 477 480 483 484 486 498 499 503 509 520 524 527 536 537 546 547 565 591 592 601 623 627 628 633 636 638 645 646 651 652 658 661 665 673 681 696 697 698 710 711 718 728 741 744 745 749 762 769
1 2 9 10 15 18 19 20 22 25 33 40 45 61 62 66 76 81 82 86 91 94 95 103 108 111 117 122 127 134 137 139 142 150 152 158 162 181 185 192 201 205 206 208 219 221 223 237 244 253 257 258 265 267 274 294 296 297 303 319 321 326 328 342 346 352 359 376 386 387 393 394 399 417 418 419 426 437 444 448 457 468 481 505 518 528 533 550 555 562 574 578 583 590 598 602 607 618 624 635 655 657 662 667 671 677 684 687 690 695 702 723 725 726 730 734 737 746 750 751 754 757 765 773 774
8 32 41 44 50 54 55 65 75 80 92 114 123 132 136 141 161 173 188 199 202 203 209 210 226 229 234 236 240 250 256 261 269 271 290 295 300 318 329 345 353 354 357 369 374 382 401 414 422 435 436 445 456 458 467 474 482 493 501 507 519 535 538 543 548 551 552 559 563 569 584 588 611 614 626 631 642 650 664 669 670 676 678 692 693 703 705 707 712 716 717 719 729 733 738 766 778
4 6 13 21 38 49 51 58 59 71 98 100 119 124 125 128 149 156 160 171 189 196 204 220 222 225 228 230 231 232 235 242 247 249 266 272 275 276 285 292 302 306 309 311 322 323 341 390 391 412 430 447 450 451 452 461 462 464 475 476 492 494 496 504 506 510 512 514 526 532 539 540 542 554 561 564 568 577 589 596 597 605 606 619 621 629 644 674 679 689 691 694 713 735 739 740 748 758 775 777 779
780 781 782 783 784 785 786 787 788 789 790 791 792 793 794 795
