4 10 11 12 14 20 29 48 53 65 79 81 83 84 94 96 97 99 117 118 122 126 132 133 154 155 158 164 166 175 178 190 196 199 201 210 214 229 230 231 243 247 258 266 270 274 276 278 283 287 289 299 310 312 313 318 325 326 329 359 371 380 387 392 394 395 396 400 408 410 412 416 424 425 427 432 437 441 442 444 445 449 450 465 496 502 505 514 518 520 532 537 539 542 549 556 561 562 565 569 571 580 582 592 599 600 603 607 609 614 622 623 643 651 652 665 670 672 705 711 715 716 722 729 731 732 733 735 744 758 764 765
2 6 13 17 18 23 36 44 45 49 54 55 57 74 78 89 91 95 98 100 104 108 112 116 119 120 121 123 131 139 141 142 148 149 152 156 165 168 173 184 194 200 205 212 219 220 239 249 253 255 256 259 264 267 271 272 288 291 292 293 300 304 306 308 314 320 336 338 343 348 353 356 361 364 365 374 376 385 386 409 428 431 433 440 451 459 481 484 490 494 507 515 519 523 528 529 538 543 545 547 552 558 560 567 570 573 574 576 579 583 588 594 597 605 608 610 611 626 639 656 661 676 677 682 683 692 694 707 710 740 749 753 761 768 774 775 777 779
5 8 16 22 31 35 40 47 51 52 61 64 69 85 92 93 106 107 125 137 138 140 145 147 150 157 159 160 163 171 172 183 185 188 189 195 198 202 203 204 206 225 232 237 240 246 263 273 280 290 303 305 317 333 342 345 351 363 367 372 373 393 397 405 411 413 415 419 454 456 457 466 472 475 478 479 480 482 488 495 504 526 530 548 557 564 566 575 584 591 595 598 601 606 613 615 616 618 619 620 621 629 630 633 637 645 647 649 650 658 659 662 668 669 671 681 699 700 704 706 713 724 726 736 738 739 745 746 747 752 757 773
1 25 26 28 38 39 41 67 70 72 73 82 86 105 109 115 128 129 130 146 153 162 167 174 180 186 207 209 213 227 241 254 260 262 277 279 284 296 297 302 309 315 319 323 324 327 332 344 346 350 355 357 358 360 368 370 378 384 388 389 406 417 422 423 430 439 461 470 471 487 489 498 499 501 503 511 535 554 563 589 590 593 596 604 625 631 634 638 679 684 685 693 695 697 698 727 734 737 748 763 770
7 15 21 24 30 32 37 42 46 50 58 71 75 77 88 124 127 134 136 143 161 169 181 191 192 197 215 217 218 221 222 235 236 238 252 261 265 275 281 285 295 298 301 307 322 331 341 352 362 375 381 382 390 391 399 401 404 421 448 462 467 473 483 491 493 497 506 508 510 512 513 517 522 525 531 534 541 546 551 559 568 577 585 586 587 602 612 627 632 636 641 642 653 654 655 657 673 675 686 688 696 701 709 712 720 721 723 730 741 771 772 776 778
9 19 33 43 59 60 62 63 68 76 80 87 90 101 102 103 111 113 135 151 170 177 187 208 211 216 223 226 228 233 242 244 245 250 257 268 269 282 286 294 311 316 321 328 334 337 340 347 354 366 369 377 398 403 407 414 418 420 426 434 435 436 443 446 447 452 453 455 458 460 464 468 469 474 476 477 492 509 516 533 536 540 550 553 555 572 578 617 624 628 635 644 648 664 666 667 674 678 687 691 702 714 718 719 725 743 750 751 754 756 760 762 766 769
3 27 34 56 66 110 114 144 176 179 182 193 224 234 248 251 330 335 339 349 379 383 402 429 438 463 485 486 500 521 524 527 544 581 640 646 660 663 680 689 690 703 708 717 728 742 755 759 767
780 781 782 783 784 785 786 787 788 789 790 791 792 793 794 795
