3 4 6 15 40 41 52 77 90 93 104 111 168 204 226 227 229 231 232 236 246 254 269 275 278 284 291 297 304 308 320 331 341 342 354 362 372 385 396 405 409 414 427 457 472 483 487 497 499 519 520 524 525 552 555 557 567 577 584 587 593 598 603 605 628 639 645 651 701 721 756 758 768 774 783 793 803 805 827 829 838 839 855 866 876 880 881 883 895 902 904 908 929 943 944 952 955 962 972 979 982 984 990 993 996 1002 1010 1024 1026 1031 1039 1045 1052 1064 1076 1078 1080 1086 1087 1097 1112 1115 1133 1146 1157 1158 1172 1173 1181 1191 1195 1197 1201 1216 1222 1232 1234 1237 1244 1247 1255 1257 1259 1261 1273 1283 1287 1302 1304 1307 1312 1322 1339 1345 1350 1352 1358 1366 1368 1383 1390 1391 1393 1401 1405 1423 1442 1453 1474 1486 1491 1499 1511 1526 1532 1538 1555 1557 1563 1604 1613 1633 1645 1656 1658 1660 1673 1691 1714 1718 1722 1735 1737 1769 1777 1782 1783 1794 1811 1819 1827 1828 1832 1834 1842 1843 1848 1856 1878 1881 1890 1893 1944 1974 1977 2003 2012 2020 2023 2030 2045 2052 2061 2063 2069 2086 2110 2130 2131 2135 2157 2179 2187 2188 2189 2205 2220 2230 2234 2252 2259 2261 2272 2277 2287 2306 2310 2311 2319 2321 2325
1 9 18 23 27 39 57 58 62 85 91 92 96 117 119 124 134 138 145 149 156 162 164 167 171 173 176 196 211 221 234 237 245 255 263 268 277 282 299 301 303 310 335 349 353 361 364 365 374 375 378 379 381 384 388 394 403 416 422 424 425 428 441 454 455 468 469 470 476 479 485 505 509 510 515 516 518 522 533 547 570 573 581 588 592 599 601 607 623 629 647 650 652 654 656 659 660 664 668 670 676 683 690 691 692 694 705 713 717 726 742 744 752 762 763 767 776 779 782 784 796 799 806 811 812 826 834 840 850 872 885 900 910 915 925 927 935 938 941 961 971 1008 1012 1023 1028 1043 1053 1062 1065 1072 1082 1096 1102 1105 1108 1117 1121 1124 1128 1137 1139 1140 1143 1144 1148 1153 1159 1164 1168 1169 1192 1194 1198 1218 1221 1229 1230 1243 1258 1267 1271 1274 1298 1306 1311 1316 1324 1326 1338 1348 1355 1361 1381 1382 1385 1387 1398 1404 1410 1412 1417 1418 1419 1421 1426 1433 1435 1436 1441 1443 1447 1450 1457 1458 1464 1467 1469 1480 1483 1487 1492 1493 1502 1534 1547 1549 1553 1560 1566 1575 1576 1577 1586 1599 1623 1631 1636 1639 1647 1653 1662 1669 1690 1701 1721 1730 1734 1747 1749 1754 1766 1772 1788 1795 1799 1808 1814 1824 1826 1835 1836 1837 1840 1849 1862 1865 1887 1888 1899 1908 1935 1940 1948 1949 1950 1969 1981 1983 1984 1992 1995 1998 2006 2007 2013 2016 2038 2041 2047 2049 2053 2055 2067 2074 2091 2093 2094 2116 2118 2124 2125 2141 2142 2143 2149 2151 2158 2164 2171 2172 2175 2183 2186 2197 2201 2203 2223 2224 2226 2229 2238 2245 2279 2284 2286 2289 2292 2293 2298 2303 2312 2313 2323 2328 2331 2332 2337
14 36 53 64 69 79 82 94 95 97 102 103 109 112 113 144 151 186 188 192 198 200 203 225 228 238 243 244 247 249 252 279 283 288 289 293 306 307 318 327 328 338 339 351 358 380 389 404 415 418 430 434 439 446 458 462 473 488 491 494 496 504 527 528 529 534 538 543 551 559 561 564 566 572 576 579 589 600 608 611 619 625 627 631 667 669 677 681 682 686 703 706 719 722 738 748 751 753 757 760 772 786 809 822 828 845 854 867 869 878 882 884 891 894 921 926 936 956 958 983 985 992 999 1000 1009 1019 1034 1036 1040 1042 1050 1051 1057 1073 1075 1083 1101 1109 1119 1125 1131 1136 1145 1161 1167 1171 1187 1190 1196 1213 1220 1245 1251 1269 1270 1276 1292 1299 1301 1308 1325 1333 1335 1336 1342 1347 1349 1357 1372 1376 1386 1389 1394 1397 1406 1407 1408 1411 1424 1425 1430 1437 1439 1468 1489 1503 1514 1521 1522 1523 1527 1531 1535 1540 1541 1543 1558 1561 1572 1582 1583 1585 1587 1590 1595 1605 1617 1619 1621 1624 1643 1644 1654 1663 1674 1685 1702 1707 1712 1724 1726 1727 1739 1746 1751 1752 1762 1770 1775 1776 1790 1792 1793 1803 1829 1833 1839 1846 1854 1860 1871 1873 1889 1895 1901 1916 1918 1924 1927 1930 1942 1952 1953 1955 1962 1965 1972 1975 1993 1994 1999 2014 2019 2022 2035 2042 2043 2046 2051 2059 2072 2075 2077 2082 2090 2098 2099 2104 2105 2106 2109 2112 2113 2122 2134 2136 2138 2153 2154 2156 2162 2170 2173 2178 2180 2182 2190 2196 2200 2207 2208 2209 2210 2216 2225 2232 2233 2235 2241 2242 2244 2253 2258 2267 2271 2276 2281 2285 2288 2290 2295 2307 2316 2322 2324 2329 2338
7 16 17 29 37 38 43 44 45 50 51 55 68 74 81 98 99 105 107 120 126 129 136 137 139 152 158 169 174 178 179 201 202 208 209 222 239 240 241 250 251 253 256 257 261 266 270 273 274 276 285 286 294 295 309 316 322 323 324 329 332 333 337 345 386 397 401 431 436 459 471 474 481 486 492 493 501 514 521 537 539 540 560 563 565 571 578 580 582 583 591 596 610 612 614 615 621 633 635 640 648 653 657 658 675 689 698 699 702 709 716 732 739 754 755 759 765 766 769 777 781 790 792 794 801 802 804 808 815 818 824 836 841 844 849 858 860 864 865 870 871 874 888 890 893 896 899 901 903 907 917 922 924 930 931 934 939 940 942 949 960 967 970 977 978 980 981 986 991 994 1003 1004 1007 1013 1014 1017 1018 1022 1025 1029 1032 1049 1055 1058 1060 1066 1067 1070 1088 1091 1098 1100 1106 1111 1114 1116 1118 1120 1126 1134 1155 1162 1176 1178 1193 1208 1210 1211 1242 1248 1277 1280 1286 1291 1300 1330 1337 1341 1354 1359 1367 1375 1377 1388 1392 1400 1409 1413 1420 1438 1440 1454 1455 1460 1465 1471 1477 1490 1494 1495 1497 1513 1515 1517 1519 1525 1528 1529 1533 1548 1550 1569 1570 1578 1579 1580 1597 1602 1606 1611 1615 1616 1618 1626 1629 1638 1640 1649 1657 1665 1667 1678 1686 1688 1694 1698 1699 1700 1719 1720 1725 1740 1750 1753 1755 1756 1758 1764 1771 1785 1789 1796 1809 1810 1815 1825 1831 1838 1864 1868 1876 1882 1892 1897 1904 1910 1911 1913 1914 1917 1936 1937 1947 1961 1973 1986 1990 1991 2000 2010 2015 2017 2024 2026 2036 2048 2064 2078 2092 2096 2100 2111 2115 2129 2150 2161 2166 2168 2169 2206 2211 2215 2217 2222 2239 2243 2247 2250 2251 2265 2266 2278 2282 2294 2315 2318 2334
2 19 21 28 54 59 60 63 67 70 71 73 75 76 88 101 106 110 114 118 121 122 123 130 132 135 140 150 160 172 177 182 183 191 194 197 199 212 213 217 233 242 248 262 271 272 280 290 305 312 313 314 315 319 321 325 326 348 355 360 366 367 368 369 398 419 420 421 423 438 444 447 449 451 453 460 463 466 482 489 490 498 508 512 513 541 545 546 549 550 553 554 556 562 586 590 594 595 606 609 620 636 641 655 661 662 665 671 672 678 684 685 688 695 700 707 708 710 729 730 733 735 736 737 741 747 749 771 778 785 791 800 821 832 835 853 857 862 875 887 898 909 913 920 923 932 947 951 953 963 964 965 995 998 1015 1016 1030 1048 1054 1056 1059 1068 1093 1095 1110 1113 1122 1127 1130 1138 1141 1142 1150 1151 1156 1163 1165 1166 1170 1174 1175 1182 1185 1200 1203 1209 1212 1226 1227 1228 1233 1235 1238 1254 1256 1263 1264 1265 1266 1272 1279 1281 1290 1295 1297 1303 1310 1318 1321 1329 1331 1343 1360 1373 1402 1415 1422 1444 1446 1449 1451 1456 1459 1461 1463 1470 1472 1473 1481 1485 1498 1504 1505 1506 1507 1508 1510 1512 1518 1520 1542 1544 1554 1556 1564 1573 1574 1591 1594 1596 1603 1607 1608 1628 1630 1632 1642 1651 1659 1661 1664 1666 1676 1680 1681 1682 1683 1697 1703 1706 1710 1713 1717 1728 1729 1731 1732 1780 1781 1786 1787 1797 1800 1801 1804 1813 1847 1857 1858 1859 1863 1867 1870 1877 1879 1880 1883 1884 1896 1920 1921 1922 1923 1925 1933 1934 1941 1943 1945 1954 1956 1957 1960 1964 1966 1968 1971 1985 1988 1996 2001 2004 2008 2009 2018 2025 2039 2044 2056 2058 2062 2065 2066 2068 2079 2083 2087 2088 2103 2114 2119 2126 2128 2133 2139 2146 2147 2155 2159 2167 2176 2198 2199 2218 2227 2237 2246 2248 2254 2263 2273 2275 2297 2299 2302 2305 2308 2314 2327 2335
8 20 22 30 32 46 47 48 56 78 115 116 127 131 147 154 161 166 181 185 193 207 215 218 219 220 224 258 287 296 298 311 340 344 357 359 370 377 382 383 387 390 391 399 407 410 411 412 426 432 433 435 437 440 445 450 452 456 461 467 477 478 480 495 511 517 526 536 544 558 569 574 575 597 602 604 617 622 632 634 637 638 644 663 666 674 687 693 697 704 711 718 723 724 727 734 745 750 761 773 780 789 798 807 816 817 819 820 823 830 833 842 843 846 847 848 851 852 861 868 877 879 889 906 911 912 914 919 933 937 945 957 966 973 975 976 987 988 989 1011 1020 1033 1038 1041 1046 1069 1074 1077 1084 1085 1103 1107 1132 1147 1184 1186 1199 1202 1205 1223 1239 1240 1249 1275 1282 1284 1285 1293 1296 1313 1317 1323 1327 1332 1340 1346 1353 1363 1364 1365 1379 1384 1395 1403 1428 1434 1445 1462 1466 1478 1479 1482 1484 1496 1500 1501 1509 1524 1536 1539 1545 1551 1552 1562 1567 1571 1581 1584 1588 1589 1600 1609 1610 1612 1614 1627 1634 1635 1637 1641 1648 1650 1652 1668 1670 1672 1675 1684 1692 1693 1696 1704 1715 1748 1757 1763 1765 1767 1773 1774 1778 1784 1798 1806 1807 1817 1818 1821 1822 1841 1845 1850 1855 1866 1869 1874 1875 1886 1891 1894 1900 1905 1919 1928 1931 1938 1939 1951 1958 1959 1963 1967 1978 1989 2002 2011 2021 2027 2033 2037 2060 2070 2071 2073 2080 2085 2089 2095 2097 2102 2132 2140 2152 2160 2174 2191 2202 2204 2212 2214 2219 2221 2231 2249 2255 2257 2260 2264 2268 2269 2270 2296 2300 2301 2304 2309 2330
5 10 11 12 13 24 25 26 31 33 34 35 42 49 61 65 66 72 80 83 84 86 87 89 100 108 125 128 133 141 142 143 146 148 153 155 157 159 163 165 170 175 180 184 187 189 190 195 205 206 210 214 216 223 230 235 259 260 264 265 267 281 292 300 302 317 330 334 336 343 346 347 350 352 356 363 371 373 376 392 393 395 400 402 406 408 413 417 429 442 443 448 464 465 475 484 500 502 503 506 507 523 530 531 532 535 542 548 568 585 613 616 618 624 626 630 642 643 646 649 673 679 680 696 712 714 715 720 725 728 731 740 743 746 764 770 775 787 788 795 797 810 813 814 825 831 837 856 859 863 873 886 892 897 905 916 918 928 946 948 950 954 959 968 969 974 997 1001 1005 1006 1021 1027 1035 1037 1044 1047 1061 1063 1071 1079 1081 1089 1090 1092 1094 1099 1104 1123 1129 1135 1149 1152 1154 1160 1177 1179 1180 1183 1188 1189 1204 1206 1207 1214 1215 1217 1219 1224 1225 1231 1236 1241 1246 1250 1252 1253 1260 1262 1268 1278 1288 1289 1294 1305 1309 1314 1315 1319 1320 1328 1334 1344 1351 1356 1362 1369 1370 1371 1374 1378 1380 1396 1399 1414 1416 1427 1429 1431 1432 1448 1452 1475 1476 1488 1516 1530 1537 1546 1559 1565 1568 1592 1593 1598 1601 1620 1622 1625 1646 1655 1671 1677 1679 1687 1689 1695 1705 1708 1709 1711 1716 1723 1733 1736 1738 1741 1742 1743 1744 1745 1759 1760 1761 1768 1779 1791 1802 1805 1812 1816 1820 1823 1830 1844 1851 1852 1853 1861 1872 1885 1898 1902 1903 1906 1907 1909 1912 1915 1926 1929 1932 1946 1970 1976 1979 1980 1982 1987 1997 2005 2028 2029 2031 2032 2034 2040 2050 2054 2057 2076 2081 2084 2101 2107 2108 2117 2120 2121 2123 2127 2137 2144 2145 2148 2163 2165 2177 2181 2184 2185 2192 2193 2194 2195 2213 2228 2236 2240 2256 2262 2274 2280 2283 2291 2317 2320 2326 2333 2336
