5 8 10 19 27 37 39 41 43 47 51 56 58 59 60 64 66 71 72 73 76 77 88 92 97 100 101 103 109 114 120 126 127 128 130 131 136 152 163 165 166 167 175 176 180 184 185 189 191 199 201 204 207 209 221 225 232 235 236 239 240 246 248 250 260 261 263 264 276 286 306 308 315 321 324 327 328 337 342 344 345 347 354 356 380 390 395 402 403 405 412 413 415 430 433 437 447 452 460 463 466 489 496 498 503 504 509 527 531 533 537 539 541 556 566 569 577 586 590 592 596 598 599 600 610 612 620 624 625 628 630 635 641 644 649 665 666 676 677 678 694 696 698 700 706 709 717 730 732 734 735 739 743 750 753 766 771 775 781 783 790 807 811 815 816 819 820 831 838 839 842 844 854 857 867 870 900 912 917 926 927 930 931 941 943 959 962 971 972 975 977 982 984 985 988 994 996 999 1000 1001 1008 1010 1023 1024 1026 1037 1038 1040 1043 1050 1058 1059 1060 1062 1065 1068 1069 1071 1073 1078 1081 1088 1098 1100 1105 1108 1111 1113 1117 1136 1142 1144 1145 1148 1155 1169 1172 1173 1180 1190 1197 1198 1219 1223 1227 1241 1244 1249 1257 1266 1269 1272 1277 1280 1282 1283 1284 1287 1295 1305 1307 1314 1322 1348
1 3 6 14 15 18 29 31 33 34 36 53 55 67 79 80 83 84 86 87 90 95 107 111 123 132 137 140 141 142 147 148 153 156 157 168 169 170 173 187 195 198 203 218 219 223 228 229 231 234 241 244 249 259 265 269 277 278 289 290 294 297 301 309 310 318 319 325 335 336 338 346 350 355 357 362 363 364 365 366 371 387 388 396 399 404 411 420 421 450 455 462 469 473 479 482 490 493 500 507 517 520 521 522 523 534 552 589 591 593 601 627 632 633 636 640 642 652 653 656 674 686 697 703 711 712 721 727 728 741 745 751 752 755 758 772 776 780 784 786 800 804 805 809 810 821 824 826 827 830 833 835 837 849 861 862 865 874 878 884 887 899 913 915 919 920 928 939 945 948 950 951 957 965 967 974 976 981 986 993 1006 1020 1021 1027 1032 1033 1041 1047 1052 1064 1066 1067 1074 1076 1083 1084 1086 1094 1110 1114 1115 1116 1120 1125 1127 1128 1130 1137 1141 1146 1152 1153 1156 1159 1162 1166 1168 1187 1191 1202 1208 1209 1210 1214 1216 1220 1228 1233 1248 1252 1255 1261 1270 1271 1275 1278 1286 1288 1291 1294 1309 1312 1316 1319 1321 1326 1336 1343 1344 1345 1350
2 12 13 16 20 22 28 45 50 54 70 82 89 98 99 102 106 108 113 122 124 129 135 151 154 155 158 159 174 177 178 179 182 190 202 208 211 217 222 224 238 243 254 255 267 268 270 280 284 287 288 291 298 300 302 305 313 314 316 330 334 343 353 359 360 367 369 370 376 379 383 385 386 392 400 408 416 426 428 432 438 440 443 444 445 458 465 468 471 475 476 477 478 494 501 508 515 526 529 530 536 542 543 545 547 558 559 560 563 571 574 575 581 603 604 623 626 629 647 648 650 651 655 668 669 671 673 675 683 684 685 689 691 692 695 702 707 713 726 729 737 756 764 769 778 787 793 794 814 817 822 832 834 846 848 850 851 855 856 860 872 879 880 889 891 895 901 904 905 906 932 937 942 947 952 955 956 961 970 973 978 980 987 1003 1009 1012 1015 1019 1035 1036 1039 1049 1053 1057 1061 1070 1072 1077 1087 1090 1091 1092 1102 1109 1112 1118 1133 1134 1135 1143 1150 1157 1158 1161 1163 1164 1175 1179 1182 1184 1186 1189 1203 1204 1207 1211 1213 1217 1221 1230 1232 1245 1247 1253 1256 1259 1267 1279 1293 1297 1299 1302 1306 1308 1310 1311 1315 1317 1318 1327 1330 1331 1332 1333 1337 1346 1347 1349
4 7 9 11 21 25 26 30 32 35 38 42 44 48 52 57 62 63 65 74 75 78 85 91 96 104 110 112 115 116 117 121 134 138 144 146 161 171 188 192 193 197 200 205 206 210 213 214 215 216 230 242 247 251 252 253 256 273 274 281 282 295 296 303 304 307 311 312 322 331 332 333 339 348 352 361 372 374 381 384 389 391 397 398 417 425 429 431 434 435 436 441 448 453 456 459 481 484 485 486 487 495 502 505 511 513 525 532 538 544 546 549 554 557 561 567 573 576 579 583 584 585 587 595 605 606 608 613 616 621 622 631 638 645 646 659 661 662 663 672 679 690 693 699 704 708 714 716 718 720 724 725 733 749 757 760 762 763 767 770 779 785 792 797 798 801 802 806 829 840 859 871 873 875 876 881 886 888 892 893 894 897 902 910 914 916 924 925 940 944 953 960 968 979 983 989 995 998 1011 1013 1014 1018 1022 1025 1031 1034 1044 1045 1054 1089 1095 1096 1099 1101 1124 1126 1131 1139 1140 1160 1165 1170 1199 1200 1205 1206 1222 1226 1229 1234 1235 1236 1240 1246 1250 1254 1262 1263 1274 1290 1296 1298 1303 1304 1323 1324 1334 1339
23 61 68 69 93 145 194 227 237 262 275 329 340 377 401 407 410 446 449 483 510 514 524 535 548 553 555 562 582 594 611 617 637 654 657 682 715 719 722 723 740 748 782 823 858 868 869 877 890 911 923 935 990 1042 1079 1138 1149 1183 1193 1215 1218 1237 1264 1301
118 119 125 139 143 160 172 181 196 257 271 272 285 320 341 349 351 358 373 375 382 409 422 427 454 457 474 480 488 499 512 519 540 551 602 607 643 658 667 687 738 742 754 759 768 777 788 789 791 803 812 828 836 841 845 847 852 883 896 907 909 918 922 934 949 958 963 966 1004 1017 1029 1030 1048 1051 1075 1082 1093 1104 1106 1107 1119 1121 1123 1132 1151 1154 1174 1176 1185 1195 1212 1224 1242 1251 1258 1260 1265 1268 1273 1276 1281 1285 1292 1300 1313 1320 1325 1328 1329 1335
17 24 40 46 49 81 94 105 133 149 150 162 164 183 186 212 220 226 233 245 258 266 279 283 292 293 299 317 323 326 368 378 393 394 406 414 418 419 423 424 439 442 451 461 464 467 470 472 491 492 497 506 516 518 528 550 564 565 568 570 572 578 580 588 597 609 614 615 618 619 634 639 660 664 670 680 681 688 701 705 710 731 736 744 746 747 761 765 773 774 795 796 799 808 813 818 825 843 853 863 864 866 882 885 898 903 908 921 929 933 936 938 946 954 964 969 991 992 997 1002 1005 1007 1016 1028 1046 1055 1056 1063 1080 1085 1097 1103 1122 1129 1147 1167 1171 1177 1178 1181 1188 1192 1194 1196 1201 1225 1231 1238 1239 1243 1289 1338 1340 1341 1342
1351 1352 1353 1354 1355 1356 1357 1358 1359 1360 1361 1362 1363 1364 1365 1366
