20	21	24	30	38	44	49	50	
2	3	6	9	10	11	13	15	16	28	31	36	43	45	
1	12	14	17	18	23	32	34	35	40	47	
19	25	27	29	37	41	42	46	
4	5	7	8	22	26	33	39	48	
