3 4 5 10 11 12 17 19 28 34 35 37 38 43 51 53 56 60 72 81 94 96 99 103 106 111 121 123 124 128 132 136 157 163 171 172 173 175 180 194 195 207 211 214 216 225 226 228 229 232 243 252 257 261 262 266 273 279 291 296 299 318 320 351 375 388 390 395 405 408 409 410 411 423 430 436 449 451 454 459 471 472 473 475 478 492 498 505 506 509 514 516 519 527 536 580 589 590 600 617 618 620 621 624 628 643 647 650 658 664 675 678 689 692 693 705 714 723 726 732 733 743 745 748 754 762 766 774
2 6 13 18 23 41 44 45 47 61 63 78 87 89 91 92 98 104 105 108 139 140 147 148 150 154 156 166 170 174 178 199 201 209 212 222 237 259 268 271 275 288 303 304 305 309 310 315 332 335 337 352 353 355 356 365 374 383 385 387 403 412 414 419 424 429 443 450 453 461 470 476 479 482 493 504 507 512 515 521 523 525 535 537 539 549 556 558 560 594 607 610 622 625 629 633 634 656 661 668 670 672 679 685 698 707 722 725 736 738 740 744 770
9 25 26 39 65 67 73 84 101 109 113 135 152 153 167 186 196 215 233 245 250 254 281 284 287 292 294 302 319 326 328 329 336 344 346 354 358 360 361 371 378 384 389 391 398 401 404 407 413 417 420 421 434 439 446 455 458 460 462 474 477 503 513 520 522 528 533 544 547 564 574 587 588 604 619 626 631 638 648 653 659 674 680 684 691 694 708 713 719 734 739 750 756 763 769 772 775 779
22 27 29 31 32 52 59 68 74 75 80 86 90 93 102 107 115 119 127 131 134 142 146 151 159 168 177 179 183 202 206 218 219 223 231 234 251 263 270 276 306 312 313 330 334 341 343 347 348 349 357 362 368 369 373 379 380 381 392 428 431 432 437 438 441 444 447 448 464 466 484 488 490 491 495 508 534 541 545 550 552 554 563 575 576 585 586 591 592 595 606 613 614 616 630 640 646 655 666 673 688 690 700 716 718 730 742 746 761 764 773
1 7 24 42 46 48 57 70 71 79 82 83 85 95 100 112 116 117 118 120 122 126 130 133 138 141 143 158 160 162 164 184 188 193 197 198 203 220 221 227 230 236 239 241 244 247 258 265 272 274 277 283 286 289 295 301 308 311 314 317 322 324 331 342 363 370 386 396 400 402 416 418 425 426 427 433 440 463 465 467 480 483 485 486 489 496 500 502 518 529 530 531 532 538 543 546 548 553 561 568 569 573 578 579 582 584 597 599 603 605 611 627 632 639 649 651 652 663 667 671 676 677 682 695 701 703 709 710 711 724 727 728 731 737 747 749 751 758 771
14 15 16 20 21 36 40 49 55 62 64 76 77 88 97 125 137 144 145 149 155 165 185 187 189 190 200 204 205 208 210 213 217 235 242 248 249 253 255 264 269 278 280 285 293 297 298 307 316 321 323 325 327 333 338 339 340 350 359 364 366 367 372 393 394 397 399 406 422 442 445 452 456 457 468 481 494 497 499 501 510 511 540 542 555 557 559 570 572 577 583 596 598 601 602 609 612 623 635 641 642 644 657 662 665 669 681 699 706 715 720 721 729 735 741 753 757 765 768 776
8 30 33 50 54 58 66 69 110 114 129 161 169 176 181 182 191 192 224 238 240 246 256 260 267 282 290 300 345 376 377 382 415 435 469 487 517 524 526 551 562 565 566 567 571 581 593 608 615 636 637 645 654 660 683 686 687 696 697 702 704 712 717 752 755 759 760 767 777 778
