2 8 10 20 21 25 35 36 42 44 59 62 67 79 80 81 82 85
3 4 13 15 27 31 34 47 48 50 53 56 60 63 68 71 76 78 83
9 16 24 26 29 30 39 45 51 54 72 77 86 87
1 11 18 19 28 32 37 38 40 41 46 49 52 57 58 61 64 65 69 70 73
5 6 7 12 14 17 22 23 33 43 55 66 74 75 84
