9 13 15 16 19 21 24 25 29 32 36 42 67 71 82 83 88 91 95 103 107 112 116 119 130 131 142 154 156 159 166 168 170 175 177 182 184 190 192 206 213 218 221 245 251 258 282 287 294 298 299 301 302 305 307 317 320 333 334 344 352 353 381 388 391 404 410 417 418 421 428 430 441 450 452 461 463 467 494 499 501 507 508 509 510 512 520 521 522 524 539 563 583 584 590 591 593 596 597 601 602 611 616 618 619 628 629 635 639 651 653 657 662 665 675 676 680 685 695 698 700 719 721 731 739 741 744 756 766 772 774 775 780 803 809 817 828 836 838 852 855 869 874 878 892 899 917 921 933 938 939 941 946 951 952 964 969 972 986 987 992 993 1008 1009 1010 1018 1037 1053 1055 1058 1064 1071 1073 1077 1086 1096 1115 1117 1120 1124 1127 1133 1136 1143 1152 1153 1155 1157 1161 1163 1173 1183 1184 1186 1194 1197 1201 1204 1207 1216 1222 1224 1236 1237 1251 1258 1273 1279 1291 1309 1313 1317 1319 1320 1329 1335 1339 1349
4 10 27 38 40 48 50 65 73 81 89 94 100 102 106 109 132 135 137 140 150 153 155 194 208 211 227 232 237 246 253 255 263 271 275 284 285 293 297 300 303 314 318 319 321 326 332 335 339 341 345 355 375 377 383 384 387 389 397 399 405 407 412 420 432 442 451 459 469 471 473 474 479 480 485 489 498 511 514 523 526 530 534 545 546 548 551 559 566 575 578 604 607 610 617 640 646 655 663 667 672 673 677 681 682 688 689 699 701 707 720 725 729 745 751 764 765 769 770 786 787 788 790 791 793 797 823 867 871 872 875 883 886 888 891 900 904 908 909 915 948 949 954 970 973 980 984 989 991 1000 1022 1023 1024 1030 1033 1035 1042 1044 1047 1051 1056 1063 1081 1085 1095 1099 1104 1107 1110 1114 1119 1125 1132 1134 1139 1140 1145 1148 1169 1176 1177 1203 1211 1219 1221 1231 1234 1240 1245 1246 1253 1260 1263 1266 1300 1306 1314 1318 1328 1330 1345
3 6 12 14 22 26 53 62 63 64 69 72 84 92 97 111 123 125 128 143 145 151 152 158 174 178 181 195 197 202 204 216 223 230 240 241 242 243 252 262 264 266 274 281 288 296 304 324 325 328 331 337 338 342 348 350 351 357 361 371 390 398 401 406 422 423 427 429 431 433 434 436 439 440 458 476 483 488 493 495 496 503 506 516 525 533 535 537 538 549 582 588 589 614 631 632 634 650 652 658 664 666 669 678 690 692 696 722 727 733 737 738 742 748 750 752 784 802 804 808 811 825 837 842 844 864 868 881 882 894 898 903 906 911 916 918 924 926 927 929 937 944 950 953 961 962 985 988 990 995 1005 1025 1026 1027 1034 1039 1048 1052 1054 1061 1062 1072 1076 1078 1080 1082 1087 1098 1105 1106 1113 1121 1123 1131 1144 1168 1170 1190 1215 1220 1227 1233 1239 1244 1247 1252 1255 1264 1270 1275 1276 1277 1278 1282 1287 1298 1299 1302 1307 1310 1322 1338 1347 1350
5 34 35 44 45 49 76 79 115 129 134 136 138 163 167 169 176 180 183 187 191 222 228 247 249 254 257 260 273 280 292 329 359 363 369 370 372 376 382 393 396 400 409 411 424 445 454 456 457 462 470 481 482 491 492 497 540 585 598 600 605 606 613 621 626 637 643 656 670 674 679 693 697 711 728 734 753 755 762 773 777 778 789 798 805 815 816 818 831 849 859 861 876 879 884 890 919 925 931 936 943 976 981 994 998 1001 1003 1038 1040 1045 1069 1079 1092 1100 1108 1112 1118 1126 1129 1149 1158 1175 1179 1189 1191 1193 1196 1198 1200 1210 1213 1217 1226 1228 1230 1232 1242 1259 1262 1268 1274 1289 1290 1295 1296 1311 1315 1325 1326 1332 1334 1337 1341 1344 1348
7 11 18 23 41 43 46 52 54 55 56 57 59 61 66 68 70 74 75 80 85 105 114 117 120 124 127 141 144 149 157 164 185 198 199 205 209 210 214 229 239 244 248 265 267 270 272 283 290 291 312 315 316 322 327 347 349 354 356 358 362 366 367 379 385 392 394 408 413 414 443 444 448 453 465 466 468 472 487 519 528 531 541 543 550 554 558 562 569 573 576 592 603 615 624 627 636 642 647 649 654 683 684 686 703 705 708 709 714 715 724 743 746 759 767 779 785 792 794 806 813 814 822 827 833 834 839 841 848 850 851 856 857 858 870 873 877 880 889 893 902 912 935 947 955 956 959 960 966 975 979 982 996 997 1002 1004 1012 1013 1015 1017 1021 1029 1041 1059 1074 1101 1103 1109 1111 1137 1146 1150 1159 1162 1166 1171 1172 1174 1188 1202 1208 1209 1218 1250 1257 1265 1267 1288 1293 1303 1305 1324 1336
1 2 8 17 30 31 33 37 51 58 60 77 87 90 93 101 104 110 113 118 139 148 160 161 165 172 179 186 188 193 203 212 234 261 269 277 279 286 289 295 306 308 330 336 340 343 346 360 364 368 373 374 378 380 386 402 416 425 435 447 455 475 477 484 486 490 502 504 513 515 518 527 529 532 544 547 553 555 556 561 564 565 567 571 577 579 580 586 595 608 620 622 623 630 638 641 644 648 659 660 668 671 691 694 706 712 713 716 717 723 726 730 732 735 740 747 754 758 763 768 776 781 795 796 799 810 812 819 820 821 826 829 830 840 843 845 846 853 854 862 863 865 866 885 897 910 913 922 923 930 934 942 958 963 967 978 983 1006 1011 1016 1019 1028 1031 1036 1043 1046 1050 1057 1060 1066 1067 1068 1083 1084 1088 1091 1093 1094 1097 1102 1116 1122 1128 1130 1135 1138 1147 1154 1180 1185 1192 1199 1205 1206 1214 1225 1229 1243 1254 1261 1271 1280 1283 1292 1294 1297 1304 1308 1323 1327 1333 1340 1342 1343 1346
20 28 39 47 78 86 96 98 99 108 121 122 126 133 146 147 162 171 173 189 196 200 201 207 215 217 219 220 224 225 226 231 233 235 236 238 250 256 259 268 276 278 309 310 311 313 323 365 395 403 415 419 426 437 438 446 449 460 464 478 500 505 517 536 542 552 557 560 568 570 572 574 581 587 594 599 609 612 625 633 645 661 687 702 704 710 718 736 749 757 760 761 771 782 783 800 801 807 824 832 835 847 860 887 895 896 901 905 907 914 920 928 932 940 945 957 965 968 971 974 977 999 1007 1014 1020 1032 1049 1065 1070 1075 1089 1090 1141 1142 1151 1156 1160 1164 1165 1167 1178 1181 1182 1187 1195 1212 1223 1235 1238 1241 1248 1249 1256 1269 1272 1281 1284 1285 1286 1301 1312 1316 1321 1331
