10 23 33 38 39 44 54 81 85 87 90 93 95 107 111 115 116 117 119 127 132 133 137 142 156 158 172 177 179 181 193 196 197 214 217 218 224 225 226 240 241 245 257 267 273 275 280 288 292 297 298 309 334 335 336 344 345 353 375 376 383 385 387 392 395 396 423 432 455 461 466 478 492 493 495 502 505 522 525 527 535 536 553 560 561 586 587 588 589 593 598 600 602 612 614 618 624 629 631 632 634 635 639 643 653 661 664 666 669 675 677 682 683 692 698 701 713 721 734 741 746 747 762 773 788 790 791 793 794 798 810 811 815 825 829 841 865 867 869 872 880 884 885 897 902 904 905 909 911 914 924 926 928 932 936 943 950 955 957 966 968 972 975 977 978 982 988 1000 1005 1006 1007 1013 1014 1028 1029 1031 1033 1042 1048 1064 1066 1075 1082 1083 1124 1126 1128 1136 1143 1147 1151 1154 1157 1174 1185 1190 1194 1199 1202 1216 1219 1222 1225 1227 1229 1232 1248 1249 1254 1257 1272 1273 1276 1279 1282 1299 1304 1307 1309 1314 1320 1343 1344 1347 1351 1353 1355 1361 1363 1364 1369 1371 1372 1381 1382 1388 1400 1426 1428 1431 1450 1454 1458 1461 1465 1469 1470 1473 1482 1487 1488 1491 1494 1502 1506 1518 1524 1531 1533 1546 1557 1560 1566 1568 1569 1597 1599 1609 1614 1616 1623 1631 1636 1642 1646 1649 1658 1675 1679 1683 1690 1691 1695 1708 1718 1725 1731 1739 1742 1743 1751 1767 1768 1769 1776 1777 1781 1795 1802 1807 1809 1819 1827 1833 1834 1844 1847 1848 1849 1854 1900 1903 1906 1912 1915 1919 1922 1929 1933 1936 1949 1954 1956 1959 1963 1967 1973 1977 1987 1989 1996 2007 2016 2023 2062 2065 2068 2078 2082 2084 2091 2094 2103 2107 2111 2120 2123 2140 2141 2150 2152 2158 2159 2161 2171 2188 2198 2201 2205 2208 2219 2224 2236 2237 2245 2247 2249 2263 2272 2280 2298 2305 2308 2320 2325 2327 2359 2366 2375 2385 2393 2416 2419 2423 2424 2428 2435 2436 2442 2443 2457 2459 2469 2477 2482 2488 2492 2496 2497 2501 2520 2539 2551 2568 2573 2574 2578 2580 2584 2586 2596 2599 2601 2604 2613 2624 2625 2639 2642 2644 2656 2659 2666 2667 2672 2678 2687 2694 2703 2705 2710 2711 2714 2725 2728 2729 2741 2775 2777 2794 2810 2811 2812 2814 2835 2837 2839 2855 2874 2883 2885 2897 2911 2918 2923 2927 2931 2932 2937 2945 2947 2954 2958 2967 2975 2978 2998 3011 3015 3023 3030 3037 3044 3047 3049 3053 3057 3071 3073 3079 3083 3085 3095 3118 3132 3135 3137 3145 3148 3154 3157 3158 3160 3177 3187 3188 3191 3194 3202 3209 3210 3211 3215 3227 3241 3245 3247 3254 3255 3261 3264 3268 3283 3286 3287 3291 3297 3315 3320 3321 3325 3328 3330 3336 3345 3351 3361 3363 3366 3370 3384 3393 3401 3408 3413 3424 3426 3436 3437 3439 3450 3452 3453 3460 3462 3465 3467 3475 3478 3499 3502 3503 3504 3512 3514 3518 3539 3541 3554 3559 3568 3578 3585 3586 3598 3599 3600 3610 3615 3619 3622 3626 3627 3638 3646 3658 3662 3665 3683 3684 3687 3692 3702 3713 3729 3731 3734 3740 3742 3746 3752 3753 3759 3764 3788 3793 3796 3797 3805 3807 3816 3819 3820 3822 3823 3832 3843 3845 3847 3854 3868 3884 3886 3887 3895 3897 3903 3904 3912 3916 3924 3925 3933 3934 3938 3950 3966 3974 3976 3997 3999 4010 4015 4017
2 7 8 14 18 19 20 26 31 34 40 53 57 58 64 68 70 71 74 78 79 84 101 104 106 108 125 129 130 136 138 139 144 146 149 151 161 164 175 183 184 189 191 198 210 213 219 221 223 238 251 254 259 260 263 266 269 270 276 281 286 295 299 312 323 325 327 330 333 339 348 352 356 357 359 368 370 374 378 379 380 404 408 413 416 419 422 424 426 434 437 443 446 447 448 456 477 487 488 491 504 507 508 511 512 513 516 531 537 543 545 546 551 554 556 564 565 567 571 573 575 582 585 591 594 597 601 606 621 626 640 647 649 650 654 657 663 668 685 705 708 715 719 723 743 751 756 766 768 769 772 776 779 780 781 782 785 787 807 817 818 819 822 839 840 842 843 845 849 855 857 864 873 876 888 893 899 919 920 921 922 925 942 944 951 956 963 976 981 983 985 989 990 992 1002 1009 1019 1038 1040 1061 1065 1071 1072 1074 1094 1097 1101 1109 1111 1114 1115 1119 1129 1133 1135 1139 1144 1159 1162 1164 1166 1169 1173 1175 1195 1196 1197 1206 1208 1215 1220 1224 1226 1228 1231 1235 1245 1246 1250 1251 1252 1256 1265 1267 1269 1275 1277 1278 1283 1293 1297 1298 1301 1313 1315 1317 1328 1331 1334 1342 1352 1368 1387 1391 1393 1396 1398 1401 1417 1423 1430 1433 1435 1437 1441 1446 1447 1455 1460 1468 1478 1480 1489 1490 1497 1498 1509 1514 1515 1516 1519 1530 1532 1534 1536 1554 1555 1559 1563 1565 1567 1572 1574 1575 1578 1580 1589 1591 1592 1617 1618 1620 1628 1637 1659 1666 1667 1681 1698 1699 1702 1706 1710 1717 1722 1724 1726 1736 1750 1755 1764 1766 1785 1786 1797 1800 1805 1808 1818 1822 1830 1839 1841 1850 1852 1860 1862 1864 1869 1870 1873 1875 1878 1879 1890 1905 1910 1911 1914 1916 1920 1923 1924 1938 1957 1968 1986 1993 1995 2011 2022 2024 2029 2030 2033 2036 2037 2039 2047 2051 2054 2079 2083 2100 2101 2106 2109 2110 2115 2124 2144 2146 2148 2155 2167 2169 2173 2182 2183 2196 2206 2217 2221 2222 2227 2230 2246 2250 2253 2260 2269 2273 2274 2276 2279 2281 2292 2294 2300 2304 2306 2314 2316 2323 2324 2331 2334 2335 2337 2346 2348 2373 2377 2386 2387 2403 2405 2406 2407 2408 2411 2422 2433 2447 2450 2451 2463 2466 2468 2471 2472 2476 2478 2481 2491 2493 2499 2504 2505 2506 2507 2509 2510 2522 2533 2537 2546 2549 2550 2562 2564 2567 2571 2579 2590 2602 2617 2619 2621 2622 2630 2631 2638 2649 2653 2681 2685 2691 2697 2708 2716 2720 2723 2726 2731 2734 2742 2744 2746 2747 2754 2778 2786 2795 2796 2798 2801 2802 2806 2807 2809 2819 2828 2829 2832 2838 2840 2841 2844 2849 2853 2857 2858 2863 2870 2879 2882 2891 2895 2904 2914 2917 2929 2949 2953 2957 2963 2976 2980 2981 2982 2984 2987 2989 2991 2995 3002 3005 3012 3031 3056 3060 3072 3078 3088 3092 3099 3107 3119 3120 3131 3139 3143 3144 3163 3167 3180 3186 3189 3197 3200 3201 3207 3212 3216 3220 3228 3231 3233 3239 3256 3258 3260 3267 3272 3285 3307 3310 3334 3339 3355 3357 3364 3374 3377 3385 3396 3397 3412 3422 3429 3447 3451 3470 3474 3476 3481 3483 3494 3500 3510 3511 3513 3517 3522 3526 3527 3529 3536 3549 3560 3561 3575 3581 3584 3594 3609 3612 3639 3642 3651 3670 3674 3676 3689 3695 3701 3716 3719 3721 3728 3730 3732 3737 3743 3754 3775 3795 3800 3810 3814 3827 3848 3856 3861 3864 3867 3869 3875 3880 3883 3888 3890 3891 3892 3896 3900 3901 3908 3915 3923 3927 3928 3935 3937 3945 3953 3957 3964 3971 3979 3989 3995 4000 4009 4011 4021 4023 4032 4037 4040 4045
3 13 15 22 35 45 52 72 75 102 112 120 121 124 153 154 160 167 168 170 173 185 186 228 231 246 252 255 261 272 274 285 291 303 321 328 340 358 390 391 397 414 418 441 452 454 465 467 473 480 529 547 552 557 566 584 592 596 620 636 645 648 655 660 667 676 678 684 690 694 695 696 703 714 739 744 750 757 760 765 777 802 808 824 827 828 831 832 835 847 858 866 871 903 906 910 917 918 933 934 938 940 941 945 946 953 958 962 967 969 984 986 995 1016 1017 1021 1024 1034 1037 1049 1067 1091 1092 1099 1113 1117 1122 1127 1141 1145 1148 1172 1188 1200 1203 1209 1233 1234 1236 1243 1258 1259 1264 1274 1281 1290 1318 1322 1330 1338 1348 1349 1359 1360 1366 1367 1370 1378 1383 1385 1389 1390 1399 1402 1405 1419 1424 1452 1462 1471 1472 1476 1508 1512 1520 1526 1535 1542 1547 1549 1551 1564 1586 1593 1596 1607 1608 1612 1622 1629 1633 1644 1650 1651 1652 1653 1660 1661 1663 1669 1670 1684 1689 1697 1703 1704 1713 1714 1716 1723 1737 1752 1757 1758 1763 1784 1787 1792 1796 1806 1810 1816 1823 1825 1828 1831 1835 1842 1863 1865 1877 1883 1884 1886 1888 1907 1909 1925 1930 1940 1951 1953 1955 1960 1964 1966 1975 1978 1979 1982 1994 1998 2003 2006 2013 2020 2041 2048 2058 2061 2063 2064 2066 2089 2093 2099 2105 2118 2122 2134 2137 2138 2139 2170 2172 2175 2176 2178 2184 2187 2189 2191 2195 2199 2200 2215 2220 2229 2232 2233 2240 2242 2254 2258 2265 2266 2270 2271 2286 2288 2309 2313 2318 2319 2322 2343 2351 2362 2367 2378 2380 2390 2395 2399 2400 2410 2430 2440 2452 2454 2462 2484 2490 2498 2513 2521 2527 2528 2530 2532 2542 2547 2548 2560 2572 2575 2577 2595 2597 2618 2620 2641 2645 2651 2652 2661 2665 2674 2679 2696 2699 2701 2704 2721 2732 2736 2750 2759 2761 2773 2784 2792 2793 2804 2808 2820 2842 2843 2867 2871 2877 2878 2910 2913 2922 2930 2934 2940 2942 2964 2969 2985 2988 2990 2994 3000 3001 3009 3016 3017 3024 3039 3041 3051 3055 3058 3059 3062 3069 3075 3081 3084 3090 3098 3100 3111 3114 3121 3123 3133 3136 3138 3140 3150 3156 3161 3162 3168 3171 3172 3179 3213 3221 3226 3240 3246 3248 3265 3270 3275 3277 3282 3290 3293 3295 3298 3308 3309 3313 3318 3323 3329 3333 3346 3347 3348 3350 3360 3371 3382 3386 3390 3391 3399 3400 3405 3418 3427 3432 3434 3435 3444 3466 3482 3484 3498 3508 3520 3528 3531 3533 3542 3551 3563 3564 3567 3569 3572 3573 3582 3588 3589 3608 3614 3620 3624 3630 3634 3635 3640 3643 3647 3649 3664 3678 3679 3680 3699 3700 3703 3715 3724 3739 3747 3768 3769 3778 3779 3780 3784 3785 3789 3791 3799 3801 3803 3811 3812 3840 3841 3849 3866 3874 3879 3882 3885 3905 3914 3919 3921 3931 3932 3939 3942 3944 3946 3961 3965 3969 3983 3984 4006 4007 4019 4020 4035 4036 4042
4 5 11 12 16 17 21 25 27 32 41 42 47 51 55 59 66 67 69 77 82 91 97 98 100 105 110 122 131 143 147 157 159 165 188 194 195 199 201 211 220 222 229 232 234 235 249 256 258 264 271 277 278 282 284 287 289 293 294 296 301 304 306 313 314 317 319 322 324 332 338 341 342 346 347 360 369 371 372 373 377 381 394 398 399 401 407 415 421 427 428 430 433 439 440 442 444 449 451 457 462 463 469 475 476 479 482 483 489 497 500 501 503 510 514 519 530 534 540 558 576 577 580 583 595 599 609 610 616 617 627 630 637 644 646 651 656 659 662 686 687 693 700 709 710 724 729 732 740 742 758 759 761 771 775 778 783 786 792 796 801 804 806 809 836 848 852 853 854 862 877 879 881 883 887 890 894 896 901 931 935 939 973 980 991 997 999 1001 1004 1012 1018 1023 1026 1027 1041 1046 1051 1052 1062 1069 1070 1073 1076 1081 1084 1090 1096 1098 1103 1106 1112 1121 1123 1125 1130 1132 1134 1137 1140 1150 1153 1163 1167 1168 1170 1171 1176 1180 1191 1192 1239 1255 1261 1270 1271 1284 1287 1289 1300 1319 1329 1333 1336 1337 1345 1346 1350 1356 1362 1376 1397 1406 1411 1414 1415 1429 1436 1438 1444 1456 1463 1464 1481 1495 1496 1504 1505 1517 1522 1527 1528 1537 1538 1540 1545 1552 1577 1585 1588 1598 1600 1605 1615 1626 1627 1630 1634 1635 1640 1641 1657 1671 1685 1696 1712 1715 1719 1728 1734 1740 1748 1753 1756 1759 1765 1774 1782 1789 1793 1811 1838 1843 1853 1856 1872 1876 1891 1901 1917 1918 1926 1928 1934 1935 1941 1946 1972 1980 1983 1992 2000 2004 2012 2017 2018 2019 2021 2025 2027 2038 2053 2067 2069 2070 2071 2074 2075 2076 2081 2096 2102 2104 2114 2116 2119 2125 2127 2143 2147 2174 2179 2181 2204 2209 2231 2251 2257 2268 2275 2278 2283 2284 2291 2295 2296 2312 2328 2330 2339 2342 2344 2345 2349 2350 2354 2356 2358 2361 2368 2370 2371 2374 2376 2389 2391 2392 2409 2412 2414 2418 2421 2425 2434 2438 2441 2444 2445 2448 2453 2456 2460 2465 2475 2479 2485 2495 2503 2508 2515 2518 2519 2529 2534 2535 2536 2556 2558 2559 2581 2587 2592 2593 2606 2607 2612 2626 2627 2629 2635 2636 2637 2640 2654 2655 2662 2664 2668 2670 2673 2690 2692 2700 2706 2707 2713 2715 2717 2718 2724 2730 2733 2735 2749 2753 2755 2756 2770 2771 2779 2797 2805 2815 2818 2821 2825 2830 2845 2846 2848 2851 2852 2861 2865 2880 2889 2890 2896 2900 2903 2906 2921 2946 2948 2950 2952 2956 2959 2962 2965 2968 2970 2971 2974 2983 3003 3008 3018 3021 3022 3026 3032 3036 3046 3066 3067 3087 3091 3097 3101 3113 3125 3126 3128 3129 3134 3141 3142 3146 3152 3153 3166 3174 3181 3184 3196 3198 3203 3205 3208 3217 3218 3222 3225 3237 3242 3243 3244 3266 3274 3276 3279 3288 3289 3292 3294 3301 3306 3326 3327 3331 3335 3338 3341 3352 3353 3356 3362 3368 3376 3383 3392 3395 3398 3404 3407 3414 3416 3421 3423 3430 3438 3440 3441 3445 3449 3457 3464 3469 3473 3477 3487 3496 3497 3509 3515 3523 3524 3530 3540 3543 3546 3548 3556 3566 3576 3579 3590 3591 3604 3625 3628 3633 3636 3652 3653 3654 3659 3660 3661 3666 3681 3682 3688 3690 3691 3697 3708 3733 3749 3750 3751 3757 3761 3792 3809 3813 3818 3830 3831 3834 3835 3838 3846 3853 3855 3858 3862 3865 3871 3913 3920 3922 3929 3936 3940 3949 3951 3963 3967 3968 3977 3978 3982 3993 3994 4014 4018 4022 4028 4033 4047
1 9 24 36 46 48 63 86 96 99 114 128 134 140 148 163 169 171 174 178 202 204 205 209 212 216 230 233 239 244 253 300 308 310 311 316 320 326 337 382 384 386 393 409 411 417 420 438 450 453 458 468 474 490 499 509 538 539 569 574 603 607 613 622 641 670 671 672 674 679 688 691 707 711 717 726 727 735 745 752 770 803 813 821 823 826 833 834 838 844 859 868 870 875 886 889 895 898 913 915 916 937 954 960 961 964 965 987 1003 1010 1015 1050 1054 1055 1059 1063 1077 1080 1085 1086 1089 1093 1108 1116 1138 1142 1177 1178 1183 1187 1212 1214 1218 1221 1240 1247 1260 1286 1294 1295 1302 1303 1310 1321 1323 1332 1335 1339 1358 1365 1373 1374 1375 1384 1386 1403 1412 1420 1427 1434 1439 1442 1445 1448 1453 1457 1459 1475 1484 1499 1529 1541 1556 1558 1595 1611 1621 1624 1625 1655 1665 1674 1677 1686 1730 1738 1746 1770 1772 1775 1780 1788 1790 1791 1803 1814 1821 1824 1836 1837 1840 1846 1855 1866 1868 1880 1889 1894 1895 1898 1921 1927 1945 1962 1969 1974 1976 2035 2040 2045 2046 2050 2073 2077 2086 2087 2088 2112 2113 2117 2128 2132 2149 2153 2154 2163 2193 2210 2211 2212 2228 2235 2241 2262 2267 2277 2282 2293 2299 2301 2332 2341 2365 2372 2401 2402 2413 2427 2432 2439 2449 2467 2474 2480 2487 2502 2517 2525 2526 2531 2543 2561 2566 2570 2585 2588 2594 2600 2614 2615 2658 2660 2663 2671 2677 2686 2695 2737 2740 2745 2758 2760 2766 2769 2772 2785 2791 2823 2824 2827 2833 2836 2866 2868 2869 2876 2887 2888 2893 2898 2902 2909 2926 2935 2943 2960 2961 2973 2993 2996 3004 3010 3014 3029 3035 3042 3050 3064 3074 3096 3122 3130 3159 3173 3176 3178 3182 3190 3193 3204 3206 3219 3223 3229 3230 3257 3305 3340 3342 3344 3358 3359 3367 3375 3380 3388 3406 3417 3420 3425 3433 3446 3455 3479 3480 3486 3492 3493 3505 3506 3519 3525 3538 3544 3547 3550 3553 3555 3565 3596 3602 3607 3611 3617 3632 3644 3648 3650 3657 3663 3668 3672 3686 3698 3705 3706 3711 3712 3718 3725 3726 3736 3744 3756 3763 3773 3783 3798 3806 3808 3839 3844 3850 3917 3918 3926 3972 3981 3987 3990 3996 3998 4003 4012 4013 4026 4027 4029 4030 4031 4048
50 56 60 62 73 80 92 94 103 109 118 126 141 145 150 176 187 190 192 200 203 208 215 243 248 250 262 268 283 290 307 315 318 329 331 351 354 355 361 362 364 367 388 400 402 403 406 431 445 464 472 485 494 496 506 515 518 520 521 523 524 526 533 542 548 549 555 562 563 570 572 578 579 605 619 638 658 665 673 680 681 689 702 706 712 718 722 725 730 733 737 738 767 774 795 797 800 830 837 850 860 861 891 900 907 947 948 949 952 996 1008 1011 1030 1036 1039 1043 1056 1057 1058 1060 1079 1087 1088 1095 1100 1102 1104 1105 1110 1118 1131 1146 1155 1156 1161 1179 1182 1184 1189 1198 1201 1205 1207 1210 1213 1223 1237 1242 1244 1285 1288 1308 1311 1316 1324 1326 1327 1340 1341 1357 1379 1380 1404 1407 1413 1421 1422 1425 1440 1443 1466 1467 1474 1477 1479 1483 1485 1486 1492 1500 1503 1507 1510 1513 1521 1525 1548 1550 1561 1562 1571 1579 1583 1584 1587 1594 1601 1602 1603 1604 1606 1613 1619 1638 1639 1647 1654 1656 1668 1672 1678 1680 1694 1700 1705 1707 1721 1727 1729 1760 1771 1773 1778 1783 1799 1804 1813 1815 1851 1859 1871 1881 1882 1892 1896 1897 1899 1902 1908 1931 1937 1942 1944 1947 1952 1958 1961 1965 1970 1971 2001 2002 2005 2008 2026 2032 2043 2044 2057 2060 2072 2080 2085 2095 2129 2131 2133 2135 2136 2142 2145 2160 2164 2165 2166 2168 2180 2185 2186 2194 2197 2203 2207 2213 2214 2218 2225 2238 2244 2248 2252 2256 2261 2285 2287 2290 2297 2303 2311 2321 2336 2338 2352 2360 2364 2369 2383 2388 2396 2398 2415 2431 2455 2461 2464 2483 2486 2511 2512 2523 2524 2538 2540 2544 2545 2554 2557 2565 2569 2582 2583 2591 2598 2608 2609 2610 2611 2616 2628 2634 2643 2647 2669 2675 2676 2680 2688 2689 2693 2698 2709 2719 2722 2727 2739 2751 2757 2763 2764 2768 2774 2776 2780 2782 2787 2800 2816 2822 2850 2856 2860 2862 2864 2872 2881 2894 2899 2901 2915 2916 2919 2920 2925 2928 2936 2941 2944 2951 2955 2966 2977 2997 3006 3007 3013 3019 3028 3033 3038 3043 3045 3048 3063 3076 3082 3086 3089 3102 3103 3104 3110 3112 3124 3147 3151 3169 3175 3183 3192 3199 3232 3235 3249 3250 3251 3252 3253 3259 3263 3269 3278 3284 3296 3300 3302 3304 3311 3312 3317 3319 3322 3324 3332 3343 3354 3369 3378 3389 3394 3402 3403 3419 3428 3431 3442 3454 3456 3458 3461 3472 3485 3489 3495 3501 3516 3521 3535 3537 3545 3552 3558 3562 3577 3583 3601 3603 3605 3621 3623 3641 3645 3655 3667 3671 3673 3675 3677 3694 3717 3722 3727 3738 3741 3745 3748 3755 3758 3760 3765 3767 3772 3774 3782 3786 3794 3802 3804 3815 3825 3826 3837 3852 3863 3872 3876 3877 3898 3906 3909 3910 3911 3947 3952 3960 3962 3986 3988 3991 4002 4004 4005 4025 4038 4043 4046 4049
6 28 29 30 37 43 49 61 65 76 83 88 89 113 123 135 152 155 162 166 180 182 206 207 227 236 237 242 247 265 279 302 305 343 349 350 363 365 366 389 405 410 412 425 429 435 436 459 460 470 471 481 484 486 498 517 528 532 541 544 550 559 568 581 590 604 608 611 615 623 625 628 633 642 652 697 699 704 716 720 728 731 736 748 749 753 754 755 763 764 784 789 799 805 812 814 816 820 846 851 856 863 874 878 882 892 908 912 923 927 929 930 959 970 971 974 979 993 994 998 1020 1022 1025 1032 1035 1044 1045 1047 1053 1068 1078 1107 1120 1149 1152 1158 1160 1165 1181 1186 1193 1204 1211 1217 1230 1238 1241 1253 1262 1263 1266 1268 1280 1291 1292 1296 1305 1306 1312 1325 1354 1377 1392 1394 1395 1408 1409 1410 1416 1418 1432 1449 1451 1493 1501 1511 1523 1539 1543 1544 1553 1570 1573 1576 1581 1582 1590 1610 1632 1643 1645 1648 1662 1664 1673 1676 1682 1687 1688 1692 1693 1701 1709 1711 1720 1732 1733 1735 1741 1744 1745 1747 1749 1754 1761 1762 1779 1794 1798 1801 1812 1817 1820 1826 1829 1832 1845 1857 1858 1861 1867 1874 1885 1887 1893 1904 1913 1932 1939 1943 1948 1950 1981 1984 1985 1988 1990 1991 1997 1999 2009 2010 2014 2015 2028 2031 2034 2042 2049 2052 2055 2056 2059 2090 2092 2097 2098 2108 2121 2126 2130 2151 2156 2157 2162 2177 2190 2192 2202 2216 2223 2226 2234 2239 2243 2255 2259 2264 2289 2302 2307 2310 2315 2317 2326 2329 2333 2340 2347 2353 2355 2357 2363 2379 2381 2382 2384 2394 2397 2404 2417 2420 2426 2429 2437 2446 2458 2470 2473 2489 2494 2500 2514 2516 2541 2552 2553 2555 2563 2576 2589 2603 2605 2623 2632 2633 2646 2648 2650 2657 2682 2683 2684 2702 2712 2738 2743 2748 2752 2762 2765 2767 2781 2783 2788 2789 2790 2799 2803 2813 2817 2826 2831 2834 2847 2854 2859 2873 2875 2884 2886 2892 2905 2907 2908 2912 2924 2933 2938 2939 2972 2979 2986 2992 2999 3020 3025 3027 3034 3040 3052 3054 3061 3065 3068 3070 3077 3080 3093 3094 3105 3106 3108 3109 3115 3116 3117 3127 3149 3155 3164 3165 3170 3185 3195 3214 3224 3234 3236 3238 3262 3271 3273 3280 3281 3299 3303 3314 3316 3337 3349 3365 3372 3373 3379 3381 3387 3409 3410 3411 3415 3443 3448 3459 3463 3468 3471 3488 3490 3491 3507 3532 3534 3557 3570 3571 3574 3580 3587 3592 3593 3595 3597 3606 3613 3616 3618 3629 3631 3637 3656 3669 3685 3693 3696 3704 3707 3709 3710 3714 3720 3723 3735 3762 3766 3770 3771 3776 3777 3781 3787 3790 3817 3821 3824 3828 3829 3833 3836 3842 3851 3857 3859 3860 3870 3873 3878 3881 3889 3893 3894 3899 3902 3907 3930 3941 3943 3948 3954 3955 3956 3958 3959 3970 3973 3975 3980 3985 3992 4001 4008 4016 4024 4034 4039 4041 4044 4050
4051 4052 4053 4054 4055 4056 4057 4058 4059 4060 4061 4062 4063 4064 4065 4066
