3 13 29 44 49 65 87 88 93 103 104 113 125 129 133 142 145 157 160 164 167 180 182 183 191 209 220 228 242 243 250 252 259 267 272 278 279 280 283 285 297 298 299 308 309 311 314 320 322 323 325 329 336 343 347 357 364 371 376 382 386 396 399 401 409 414 419 422 432 456 461 466 469 492 496 499 500 506 527 536 538 554 556 557 561 569 588 592 594 612 616 624 625 630 639 645 647 664 679 687 696 702 705 711 712 730 732 735 739 747 756 761 774 781 782 783 789 793 802 818 820 821 834 840 847 849 860 865 868 884 895 897 898 902 907 913 917 919 920 924 925 932 940 943 944 948 949 950 953 972 976 982 991 1000 1002 1009 1013 1021 1024 1031 1052 1053 1054 1062 1070 1078 1082 1083 1087 1091 1093 1094 1112 1124 1125 1138 1142 1153 1161 1168 1172 1175 1179 1183 1189 1203 1206 1208 1214 1215 1221 1225 1229 1230 1238 1242 1244 1248 1249 1250 1258 1261 1262 1265 1273 1275 1289 1292 1296 1322 1327 1334 1336 1342 1355 1357 1358 1359 1360 1362 1364 1375 1382 1384 1389 1398 1410 1412 1413 1414 1415 1422 1427 1439 1446 1450 1451 1455 1458 1484 1489 1497 1507 1510 1529 1532 1536 1540 1559 1596 1597 1598 1601 1602 1606 1609 1610 1629 1643 1645 1648 1649 1652 1654 1656 1657 1662 1668 1681 1685 1693 1697 1699 1702 1705 1706 1707 1721 1726 1743 1746 1748 1749 1757 1760 1770 1775 1777 1783 1787 1791 1794 1799 1811 1821 1824 1826 1827 1829 1830 1843 1853 1869 1874 1875 1878 1882 1890 1895 1896 1909 1923 1929 1933 1936 1939 1945 1949 1952 1957 1959 1962 1963 1964 1967 1972 1977 1978 1998 2011 2018 2020 2021 2022 2029 2035 2037 2040 2042 2043 2050 2052 2053 2069 2072 2073 2086 2090 2092 2098 2100 2103 2104 2112 2115 2127 2136 2142 2145 2149 2156 2160 2172 2179 2196 2202 2205 2209 2212 2219 2228 2230 2242 2247 2248 2255 2282 2286 2291 2295 2301 2307 2309 2314 2326 2327 2336
2 18 27 52 56 58 59 60 64 72 74 89 95 101 106 111 116 118 134 138 144 150 155 156 172 175 188 189 190 193 196 198 210 211 215 216 217 224 226 232 236 245 251 254 255 262 281 282 291 301 307 321 333 335 345 348 368 379 380 383 384 387 403 405 410 416 426 427 428 431 444 455 467 470 472 474 476 483 485 512 513 515 519 526 543 548 555 560 567 570 571 572 578 579 583 584 587 598 600 601 608 617 620 622 623 629 631 632 654 659 667 673 678 681 682 697 703 707 713 729 750 754 760 775 776 778 779 780 792 806 808 810 829 837 852 853 861 862 880 900 914 915 929 933 935 936 941 945 946 954 974 977 987 994 996 1008 1011 1026 1039 1040 1058 1065 1069 1084 1101 1116 1122 1128 1137 1144 1157 1163 1166 1187 1201 1222 1226 1232 1234 1236 1243 1247 1251 1254 1259 1264 1266 1267 1270 1271 1293 1295 1297 1303 1305 1307 1310 1316 1321 1330 1335 1337 1339 1345 1349 1361 1373 1387 1388 1401 1417 1421 1432 1434 1435 1448 1456 1471 1474 1488 1490 1491 1499 1502 1505 1515 1516 1519 1527 1531 1534 1538 1551 1570 1573 1583 1591 1599 1607 1608 1611 1619 1628 1637 1642 1647 1651 1660 1665 1669 1670 1672 1673 1682 1686 1690 1700 1704 1708 1715 1720 1722 1723 1724 1735 1740 1764 1766 1778 1780 1782 1793 1805 1809 1810 1813 1822 1828 1834 1836 1845 1851 1856 1863 1866 1867 1877 1887 1893 1897 1903 1908 1921 1934 1935 1938 1940 1943 1947 1953 1965 1982 1991 2000 2003 2006 2007 2013 2034 2039 2045 2054 2062 2065 2070 2074 2084 2094 2096 2102 2105 2111 2113 2117 2119 2137 2141 2143 2144 2150 2153 2155 2167 2168 2170 2171 2174 2178 2182 2200 2201 2203 2207 2208 2216 2220 2224 2225 2234 2237 2257 2258 2259 2260 2266 2269 2275 2287 2299 2302 2304 2310 2312 2325 2329 2332 2333
4 6 7 8 16 19 28 36 37 40 43 45 51 55 57 66 68 76 81 85 90 96 105 107 119 123 141 149 152 161 169 173 179 184 186 201 203 205 218 221 239 260 261 263 264 270 273 274 275 284 289 293 294 296 304 306 310 316 330 362 374 389 392 398 417 424 430 435 436 440 452 453 457 460 462 468 471 481 484 486 487 491 502 504 522 524 529 535 537 545 549 563 564 575 576 581 585 593 602 604 605 611 618 621 637 638 643 651 652 655 674 684 685 689 699 701 709 716 717 720 722 724 731 758 759 777 786 798 804 811 814 827 832 835 838 839 841 842 845 859 872 885 899 901 922 926 938 942 956 957 961 963 965 967 969 973 975 980 985 986 989 1016 1018 1023 1025 1029 1041 1045 1068 1079 1085 1086 1096 1107 1117 1121 1126 1131 1136 1140 1147 1150 1171 1173 1193 1194 1195 1213 1218 1223 1228 1231 1233 1240 1253 1257 1276 1277 1278 1282 1287 1291 1306 1311 1315 1318 1319 1325 1329 1344 1348 1350 1353 1363 1369 1378 1391 1404 1408 1409 1419 1423 1429 1431 1436 1438 1440 1447 1449 1452 1453 1457 1462 1466 1475 1476 1480 1493 1494 1495 1501 1503 1521 1524 1526 1537 1541 1553 1556 1563 1567 1577 1582 1584 1587 1588 1594 1615 1626 1627 1644 1659 1677 1678 1680 1684 1691 1698 1703 1710 1727 1734 1737 1739 1745 1753 1754 1755 1765 1769 1788 1789 1792 1798 1800 1801 1804 1808 1815 1817 1833 1835 1837 1840 1842 1855 1868 1870 1881 1891 1901 1911 1915 1919 1925 1926 1927 1928 1931 1932 1944 1956 1968 1980 1983 1995 2002 2010 2023 2026 2028 2031 2048 2057 2061 2063 2075 2076 2077 2082 2091 2107 2118 2120 2121 2128 2129 2132 2139 2151 2152 2159 2162 2190 2191 2199 2206 2211 2215 2240 2244 2245 2251 2252 2264 2270 2271 2288 2296 2300 2306 2315 2321 2323 2337
9 14 15 17 21 23 24 31 33 34 38 41 47 50 54 63 67 78 97 98 102 109 110 115 122 126 127 128 130 131 132 135 147 151 171 177 178 187 192 194 199 202 207 223 225 229 233 240 246 249 256 257 258 266 269 276 290 295 303 305 313 315 324 331 337 338 344 351 359 360 366 370 372 373 375 378 385 388 391 394 395 420 438 439 447 448 449 454 459 477 482 489 490 497 501 507 511 514 517 521 525 530 532 533 539 540 544 550 552 553 565 566 580 586 590 591 597 599 606 613 614 627 634 640 650 662 663 666 669 671 675 691 692 693 695 700 710 714 721 723 725 727 728 733 734 736 737 744 751 752 755 769 785 790 794 796 801 816 824 828 848 850 857 864 871 875 878 893 909 910 916 934 951 952 960 964 971 978 981 1004 1014 1015 1020 1028 1032 1033 1034 1035 1036 1044 1046 1047 1048 1066 1073 1074 1075 1098 1104 1105 1106 1113 1114 1118 1120 1123 1127 1130 1143 1151 1156 1164 1167 1169 1178 1180 1182 1185 1188 1198 1199 1202 1212 1216 1217 1235 1241 1255 1256 1269 1284 1286 1288 1298 1299 1300 1309 1313 1314 1326 1332 1338 1351 1352 1354 1367 1368 1371 1376 1379 1381 1383 1392 1393 1394 1395 1396 1400 1402 1403 1406 1425 1428 1433 1437 1442 1444 1463 1477 1479 1481 1483 1485 1487 1492 1498 1500 1506 1509 1511 1513 1518 1520 1523 1528 1543 1545 1547 1548 1550 1555 1561 1564 1574 1575 1578 1580 1592 1604 1622 1632 1633 1634 1638 1641 1661 1664 1666 1667 1675 1676 1679 1695 1725 1728 1736 1750 1756 1771 1773 1785 1796 1797 1807 1819 1820 1832 1838 1847 1848 1852 1857 1862 1864 1865 1880 1884 1886 1889 1892 1894 1900 1902 1904 1914 1916 1917 1920 1922 1937 1946 1948 1951 1961 1966 1971 1975 1988 1989 1994 1999 2004 2008 2012 2015 2016 2036 2041 2049 2055 2058 2059 2066 2068 2078 2081 2087 2088 2089 2099 2101 2106 2123 2126 2130 2138 2146 2164 2166 2169 2177 2181 2192 2195 2214 2217 2227 2231 2243 2246 2250 2253 2263 2267 2268 2274 2278 2279 2289 2292 2294 2297 2305 2311 2313 2316 2317 2318 2320 2324 2330 2331
1 20 32 42 46 48 69 71 73 75 80 83 86 91 92 112 114 117 124 140 148 153 162 174 181 185 200 204 208 212 213 227 234 268 287 288 318 319 326 328 332 334 346 350 353 354 358 361 363 367 381 393 400 402 407 415 433 441 464 479 488 493 495 509 516 518 520 534 541 568 574 577 582 589 607 626 633 649 656 660 665 672 683 688 694 706 708 719 748 749 753 757 766 767 768 771 772 784 787 795 799 800 803 805 807 813 817 819 823 830 833 843 846 854 855 867 873 874 877 879 882 887 890 891 894 903 904 905 912 918 921 927 939 947 955 959 970 995 998 1001 1006 1007 1010 1017 1030 1037 1038 1042 1043 1049 1050 1051 1056 1057 1059 1063 1064 1067 1080 1081 1090 1100 1111 1132 1135 1145 1146 1148 1154 1159 1162 1165 1174 1177 1184 1191 1196 1197 1204 1205 1207 1209 1210 1211 1227 1245 1272 1274 1279 1281 1283 1304 1323 1324 1328 1331 1341 1347 1365 1366 1370 1372 1374 1377 1385 1390 1397 1399 1405 1407 1411 1420 1424 1426 1430 1441 1445 1454 1459 1465 1467 1468 1469 1470 1473 1482 1496 1517 1522 1530 1539 1542 1544 1546 1549 1552 1554 1558 1562 1565 1569 1576 1581 1585 1586 1590 1600 1603 1605 1613 1614 1616 1621 1624 1630 1635 1636 1639 1640 1646 1650 1655 1663 1674 1687 1689 1694 1712 1714 1716 1718 1729 1730 1731 1733 1742 1751 1752 1759 1763 1768 1772 1779 1781 1784 1786 1795 1802 1814 1818 1823 1841 1844 1846 1849 1850 1854 1858 1859 1860 1871 1873 1888 1905 1906 1910 1912 1913 1930 1942 1950 1955 1969 1973 1976 1979 1981 1984 1985 1986 1990 1992 1993 1996 2001 2014 2024 2025 2027 2030 2032 2033 2044 2046 2047 2051 2056 2071 2079 2083 2093 2108 2114 2124 2125 2131 2133 2140 2157 2176 2183 2186 2188 2189 2210 2213 2232 2235 2236 2241 2256 2261 2265 2276 2284 2285 2322 2335 2338
5 10 11 12 22 25 26 30 35 39 53 61 62 70 77 79 82 84 94 99 100 108 120 121 136 137 139 143 146 154 158 159 163 165 166 168 170 176 195 197 206 214 219 222 230 231 235 237 238 241 244 247 248 253 265 271 277 286 292 300 302 312 317 327 339 340 341 342 349 352 355 356 365 369 377 390 397 404 406 408 411 412 413 418 421 423 425 429 434 437 442 443 445 446 450 451 458 463 465 473 475 478 480 494 498 503 505 508 510 523 528 531 542 546 547 551 558 559 562 573 595 596 603 609 610 615 619 628 635 636 641 642 644 646 648 653 657 658 661 668 670 676 677 680 686 690 698 704 715 718 726 738 740 741 742 743 745 746 762 763 764 765 770 773 788 791 797 809 812 815 822 825 826 831 836 844 851 856 858 863 866 869 870 876 881 883 886 888 889 892 896 906 908 911 923 928 930 931 937 958 962 966 968 979 983 984 988 990 992 993 997 999 1003 1005 1012 1019 1022 1027 1055 1060 1061 1071 1072 1076 1077 1088 1089 1092 1095 1097 1099 1102 1103 1108 1109 1110 1115 1119 1129 1133 1134 1139 1141 1149 1152 1155 1158 1160 1170 1176 1181 1186 1190 1192 1200 1219 1220 1224 1237 1239 1246 1252 1260 1263 1268 1280 1285 1290 1294 1301 1302 1308 1312 1317 1320 1333 1340 1343 1346 1356 1380 1386 1416 1418 1443 1460 1461 1464 1472 1478 1486 1504 1508 1512 1514 1525 1533 1535 1557 1560 1566 1568 1571 1572 1579 1589 1593 1595 1612 1617 1618 1620 1623 1625 1631 1653 1658 1671 1683 1688 1692 1696 1701 1709 1711 1713 1717 1719 1732 1738 1741 1744 1747 1758 1761 1762 1767 1774 1776 1790 1803 1806 1812 1816 1825 1831 1839 1861 1872 1876 1879 1883 1885 1898 1899 1907 1918 1924 1941 1954 1958 1960 1970 1974 1987 1997 2005 2009 2017 2019 2038 2060 2064 2067 2080 2085 2095 2097 2109 2110 2116 2122 2134 2135 2147 2148 2154 2158 2161 2163 2165 2173 2175 2180 2184 2185 2187 2193 2194 2197 2198 2204 2218 2221 2222 2223 2226 2229 2233 2238 2239 2249 2254 2262 2272 2273 2277 2280 2281 2283 2290 2293 2298 2303 2308 2319 2328 2334
2339 2340 2341 2342 2343 2344 2345 2346 2347 2348 2349 2350 2351 2352 2353 2354
