3 24 35 54 56 58 61 68 84 86 95 119 129 133 150 152 157 165 175 186 192 204 218 238 242 245 246 251 253 272 279 282 287 291 298 300 301 344 349 360 361 370 385 397 403 405 412 417 425 430 436 443 448 486 487 500 506 510 511 526 528 542 579 581 585 588 618 619 627 644 673 688 696 698 705 708 714 741 754 768 770 773 795 798 810 816 824 836 857 868 887 903 907 939 943 949 952 959 964 977 982 986 992 1006 1007 1008 1013 1016 1025 1027 1028 1035 1038 1039 1050 1051 1061 1064 1068 1071 1072 1076 1081 1086 1093 1096 1115 1122 1126 1128 1132 1140 1142 1153 1154 1164 1165 1176 1179 1181 1182 1208 1212 1213 1216 1222 1223 1235 1244 1249 1254 1255 1261 1264 1279 1296 1309 1321 1332 1345 1353 1355 1367 1377 1380 1384 1386 1403 1405 1414 1425 1429 1457 1477 1479 1495 1501 1508 1513 1521 1550 1552 1555 1567 1577 1590 1591 1599 1611 1620 1626 1633 1652 1662 1670 1685 1689 1697 1698 1700 1704 1718 1723 1731 1758 1783 1784 1786 1789 1791 1792 1797 1833 1835 1838 1842 1856 1857 1867 1876 1882 1896 1904 1921 1926 1946 1959 1963 1964 1976 1998 2017 2021 2026 2033 2058 2074 2085 2097 2103 2124 2125 2151 2157 2162 2168 2173 2176 2177 2182 2198 2201 2208 2222 2233 2238 2250 2252 2260 2276 2279 2306 2313 2329 2332 2337
1 4 8 23 37 71 78 80 82 97 128 140 142 153 156 158 222 257 262 271 278 286 289 295 299 304 327 329 331 341 345 356 372 393 398 404 424 458 482 483 507 509 524 531 535 578 595 607 614 620 632 637 660 662 676 677 680 681 685 693 694 695 704 733 739 740 743 749 769 774 786 791 820 842 845 853 856 862 870 881 886 890 912 917 919 941 944 953 976 979 994 997 998 1015 1034 1041 1047 1048 1087 1090 1186 1207 1240 1251 1263 1265 1277 1283 1289 1302 1308 1318 1328 1336 1337 1339 1356 1362 1363 1390 1394 1398 1420 1436 1448 1460 1486 1491 1504 1515 1517 1543 1546 1549 1553 1573 1584 1586 1596 1605 1625 1630 1636 1637 1638 1651 1690 1695 1701 1703 1708 1709 1719 1721 1734 1735 1750 1765 1775 1779 1787 1788 1794 1800 1801 1807 1817 1819 1827 1837 1845 1852 1861 1864 1877 1888 1891 1900 1905 1908 1910 1913 1927 1944 1969 1975 1986 1990 1993 1999 2007 2019 2022 2025 2027 2029 2039 2051 2057 2059 2065 2068 2089 2091 2095 2106 2110 2116 2128 2150 2153 2158 2180 2197 2209 2218 2240 2267 2275 2288 2292 2309 2312 2334 2338
10 14 18 22 25 32 33 34 36 40 47 50 51 64 65 77 88 90 96 98 99 100 104 105 111 112 132 134 143 145 162 169 173 182 183 190 193 196 197 198 201 205 207 211 220 221 230 234 236 240 244 250 260 266 273 276 288 290 293 294 308 310 311 313 314 330 332 334 337 347 355 365 367 369 376 382 392 394 400 406 415 421 426 428 432 433 437 452 455 462 467 468 470 472 476 477 479 480 481 485 490 501 504 514 515 517 519 525 539 544 549 552 553 556 563 570 589 591 592 598 603 605 609 616 625 626 633 634 645 652 654 657 663 667 683 684 702 709 719 722 728 737 751 755 756 763 792 793 794 803 806 813 826 830 839 846 849 854 858 859 860 863 865 878 879 880 888 894 899 902 911 913 916 918 920 925 930 931 932 942 945 955 958 965 968 975 978 980 989 995 1005 1012 1026 1029 1030 1040 1053 1055 1063 1075 1080 1082 1083 1099 1100 1102 1105 1106 1109 1117 1121 1124 1129 1149 1151 1155 1156 1166 1170 1172 1177 1192 1198 1199 1203 1204 1205 1206 1217 1231 1237 1239 1241 1245 1246 1257 1260 1271 1273 1285 1288 1291 1293 1295 1297 1300 1307 1310 1312 1315 1316 1319 1320 1329 1331 1334 1361 1366 1368 1374 1395 1396 1407 1409 1422 1426 1427 1428 1433 1442 1446 1450 1463 1464 1467 1471 1473 1478 1483 1484 1496 1499 1502 1505 1506 1507 1520 1522 1523 1525 1531 1533 1536 1554 1564 1565 1571 1574 1576 1578 1579 1587 1595 1603 1609 1613 1627 1628 1635 1639 1643 1645 1654 1656 1659 1674 1684 1691 1727 1728 1738 1745 1749 1754 1757 1763 1774 1782 1803 1805 1806 1832 1836 1843 1844 1846 1851 1853 1865 1868 1874 1883 1884 1885 1887 1890 1895 1898 1906 1919 1920 1923 1928 1936 1943 1954 1962 1967 1979 1988 1992 1997 2013 2024 2034 2038 2044 2048 2071 2093 2098 2101 2104 2115 2120 2133 2134 2172 2174 2184 2185 2200 2214 2215 2217 2226 2228 2236 2241 2242 2243 2253 2262 2266 2278 2281 2290 2296 2297 2315 2316 2324 2336
2 5 7 13 15 16 17 20 31 41 43 48 49 52 57 62 67 70 73 81 87 92 101 103 106 108 109 118 120 126 135 137 151 154 160 161 163 166 174 179 181 184 188 200 203 209 210 213 226 228 235 237 239 249 255 258 263 274 277 284 306 316 317 320 321 322 323 326 335 338 340 346 348 350 353 364 368 373 374 375 377 378 379 380 388 391 395 402 408 410 418 419 422 427 438 440 445 450 457 466 478 488 495 512 521 523 533 538 545 547 550 551 554 555 559 561 567 568 583 599 604 606 611 612 636 640 642 643 646 651 664 665 672 687 697 712 715 723 724 726 727 729 730 732 735 744 745 747 750 757 760 764 780 787 796 797 804 805 807 809 825 831 838 855 867 869 871 872 874 875 883 895 905 915 927 933 934 936 938 960 961 963 970 972 974 985 991 996 999 1000 1001 1002 1003 1004 1010 1023 1037 1042 1043 1049 1057 1059 1067 1070 1077 1085 1097 1108 1113 1114 1118 1123 1125 1127 1131 1135 1138 1141 1143 1145 1152 1157 1169 1183 1184 1188 1189 1191 1194 1196 1200 1202 1225 1226 1228 1234 1238 1253 1259 1270 1272 1274 1278 1280 1281 1287 1305 1322 1341 1358 1364 1369 1372 1376 1378 1379 1381 1387 1393 1397 1402 1418 1432 1434 1440 1441 1447 1449 1453 1454 1462 1465 1469 1476 1482 1490 1492 1500 1512 1519 1526 1527 1530 1539 1541 1544 1556 1558 1568 1575 1583 1585 1592 1598 1608 1617 1619 1622 1624 1642 1648 1649 1653 1655 1669 1671 1679 1680 1682 1686 1688 1692 1694 1702 1710 1712 1725 1739 1742 1748 1755 1756 1760 1766 1767 1776 1780 1795 1799 1810 1812 1813 1820 1823 1825 1829 1839 1840 1855 1872 1879 1880 1881 1886 1899 1901 1903 1907 1911 1916 1922 1930 1934 1935 1937 1938 1941 1953 1958 1980 1982 1984 1995 2002 2006 2012 2016 2020 2037 2045 2046 2049 2056 2060 2062 2066 2069 2070 2088 2096 2108 2109 2111 2119 2127 2137 2145 2146 2155 2161 2165 2166 2170 2171 2181 2189 2190 2202 2205 2219 2220 2227 2230 2232 2234 2237 2246 2259 2273 2277 2286 2287 2293 2294 2298 2299 2302 2304 2305 2311 2314 2318 2328 2330 2331 2333
6 9 12 21 27 30 45 46 55 59 74 75 79 110 114 115 116 121 124 131 139 141 146 148 149 159 167 172 176 191 212 214 217 229 232 241 243 248 264 268 275 281 309 315 319 325 333 342 354 357 362 363 366 381 383 387 396 407 416 429 431 435 441 442 444 451 460 461 463 464 469 473 484 491 496 498 503 513 518 520 537 540 558 560 564 565 571 582 590 594 596 597 601 608 623 635 638 641 647 653 656 659 670 674 682 686 689 690 692 701 703 710 713 717 725 731 738 753 758 762 767 771 778 784 785 789 799 802 811 812 815 818 821 822 847 850 852 864 866 877 889 901 910 923 924 937 947 950 956 957 966 987 993 1009 1014 1019 1021 1024 1033 1044 1056 1058 1062 1078 1103 1104 1112 1116 1133 1146 1147 1158 1161 1163 1168 1180 1185 1190 1197 1210 1211 1218 1227 1229 1232 1236 1252 1256 1262 1266 1275 1303 1311 1323 1324 1325 1330 1335 1352 1354 1365 1371 1385 1400 1404 1417 1419 1421 1431 1443 1455 1458 1459 1474 1480 1481 1485 1493 1497 1503 1511 1518 1528 1529 1532 1537 1538 1542 1557 1561 1563 1570 1580 1589 1607 1612 1616 1640 1657 1658 1660 1663 1665 1676 1699 1705 1707 1711 1730 1732 1733 1741 1752 1753 1761 1796 1809 1811 1815 1816 1824 1831 1847 1848 1850 1854 1859 1862 1873 1878 1897 1912 1917 1924 1929 1933 1942 1949 1951 1956 1971 1973 1981 1983 1985 1994 2001 2008 2009 2010 2011 2023 2035 2036 2043 2047 2053 2064 2067 2073 2075 2076 2081 2082 2092 2100 2105 2123 2130 2131 2132 2138 2139 2142 2147 2148 2164 2175 2192 2199 2206 2207 2212 2216 2225 2229 2235 2239 2249 2255 2261 2265 2282 2284 2289 2295 2325 2327
19 28 42 53 66 69 72 85 89 93 94 102 107 113 117 122 125 130 136 138 147 155 164 168 178 180 187 194 195 199 206 208 219 223 224 231 233 247 252 254 259 265 267 269 270 280 283 296 297 302 312 324 336 343 351 358 384 386 401 409 411 413 423 434 446 447 453 474 475 493 494 502 522 527 529 530 534 536 557 562 569 573 574 575 577 580 584 586 600 602 610 613 617 621 624 628 630 631 648 649 655 658 661 666 668 669 671 678 691 699 700 711 721 736 759 761 775 776 777 779 783 788 790 801 823 827 828 834 835 837 843 848 861 873 885 891 893 896 897 898 900 906 909 922 926 928 929 940 946 948 951 962 967 983 984 990 1011 1017 1020 1032 1036 1046 1054 1069 1073 1079 1084 1088 1089 1091 1092 1101 1107 1110 1111 1120 1136 1137 1139 1150 1160 1167 1171 1174 1178 1187 1193 1195 1201 1209 1214 1215 1220 1233 1242 1243 1247 1248 1258 1268 1284 1286 1290 1292 1294 1298 1299 1304 1306 1313 1317 1327 1333 1344 1349 1351 1359 1360 1373 1383 1388 1391 1399 1406 1408 1410 1411 1412 1413 1416 1435 1438 1451 1452 1461 1466 1468 1489 1494 1498 1509 1510 1516 1524 1534 1535 1540 1559 1562 1566 1569 1572 1581 1582 1593 1594 1597 1606 1610 1614 1615 1621 1623 1629 1641 1646 1650 1661 1664 1672 1677 1678 1681 1687 1706 1717 1720 1729 1736 1740 1743 1746 1768 1773 1777 1778 1781 1785 1790 1798 1804 1814 1821 1822 1826 1830 1849 1858 1860 1863 1871 1894 1902 1918 1925 1932 1939 1940 1945 1947 1952 1957 1960 1965 1968 1972 1977 1991 2000 2014 2015 2018 2028 2030 2031 2040 2052 2054 2063 2077 2078 2083 2086 2090 2094 2099 2102 2107 2112 2117 2121 2122 2126 2129 2135 2143 2149 2154 2156 2160 2169 2187 2193 2195 2196 2203 2204 2210 2211 2213 2245 2248 2251 2268 2269 2270 2271 2280 2283 2285 2291 2300 2301 2308 2310 2319 2322 2326 2335
11 26 29 38 39 44 60 63 76 83 91 123 127 144 170 171 177 185 189 202 215 216 225 227 256 261 285 292 303 305 307 318 328 339 352 359 371 389 390 399 414 420 439 449 454 456 459 465 471 489 492 497 499 505 508 516 532 541 543 546 548 566 572 576 587 593 615 622 629 639 650 675 679 706 707 716 718 720 734 742 746 748 752 765 766 772 781 782 800 808 814 817 819 829 832 833 840 841 844 851 876 882 884 892 904 908 914 921 935 954 969 971 973 981 988 1018 1022 1031 1045 1052 1060 1065 1066 1074 1094 1095 1098 1119 1130 1134 1144 1148 1159 1162 1173 1175 1219 1221 1224 1230 1250 1267 1269 1276 1282 1301 1314 1326 1338 1340 1342 1343 1346 1347 1348 1350 1357 1370 1375 1382 1389 1392 1401 1415 1423 1424 1430 1437 1439 1444 1445 1456 1470 1472 1475 1487 1488 1514 1545 1547 1548 1551 1560 1588 1600 1601 1602 1604 1618 1631 1632 1634 1644 1647 1666 1667 1668 1673 1675 1683 1693 1696 1713 1714 1715 1716 1722 1724 1726 1737 1744 1747 1751 1759 1762 1764 1769 1770 1771 1772 1793 1802 1808 1818 1828 1834 1841 1866 1869 1870 1875 1889 1892 1893 1909 1914 1915 1931 1948 1950 1955 1961 1966 1970 1974 1978 1987 1989 1996 2003 2004 2005 2032 2041 2042 2050 2055 2061 2072 2079 2080 2084 2087 2113 2114 2118 2136 2140 2141 2144 2152 2159 2163 2167 2178 2179 2183 2186 2188 2191 2194 2221 2223 2224 2231 2244 2247 2254 2256 2257 2258 2263 2264 2272 2274 2303 2307 2317 2320 2321 2323
2339 2340 2341 2342 2343 2344 2345 2346 2347 2348 2349 2350 2351 2352 2353 2354
