5 14 20 21 23 25 29 51 54 56 58 64 66 73 77 83 86
1 6 7 12 17 27 31 34 36 37 39 43 44 45 53 60 62 63 67 68 70 74 84
3 8 13 16 18 22 24 28 30 35 38 40 41 47 48 50 55 57 59 61 65 71 72 76 78 79 81 82 85
2 4 9 10 11 15 19 26 32 33 42 46 49 52 69 75 80 87
88 89 90 91 92 93 94 95 96 97 98 99 100 101 102 103
