2	7	9	17	18	19	29	30	42	43	50	64	72	73	75	77	80	81	86	94	99	102	112	116	118	121	137	142	147	151	155	168	172	175	177	182	183	186	187	195	199	200	208	212	218	222	230	232	234	237	238	240	243	244	251	257	260	263	264	270	271	275	277	281	289	298	303	305	326	333	339	341	358	359	361	362	363	366	369	389	392	395	398	412	432	450	458	466	467	469	482	483	486	487	489	490	496	505	516	517	519	526	531	541	544	552	556	559	564	576	592	609	613	614	615	621	622	625	639	641	644	646	651	658	660	663	666	668	694	701	703	706	717	721	726	727	729	733	738	744	748	761	770	792	795	797	802	808	809	819	825	833	835	843	855	864	865	868	870	886	890	891	903	912	920	933	936	940	947	957	963	966	984	990	991	995	1018	1025	1027	1033	1041	1046	1051	1056	1061	1069	1072	1074	1091	1094	1101	1104	1105	1106	1107	1114	1116	1117	1125	1130	1140	1142	1145	1147	1154	1156	1169	1170	1171	1172	1179	1185	1195	1199	1207	1218	1219	1226	1232	1236	1246	1247	1249	1263	1269	1275	1280	1284	1302	1316	1317	1319	1321	1324	1340	1342	1352	1365	1372	1382	1383	1389	1391	1393	1399	1401	1403	1411	1425	1427	1437	1439	1445	1447	1448	1453	1455	1458	1463	1466	1472	1479	1480	1481	1482	1485	1490	1491	1492	1496	1499	1502	1513	1515	1519	1522	1536	1547	1550	1557	1568	1580	1589	1592	1595	1609	1612	1613	1619	1622	1623	1634	1635	1647	1648	1659	1660	1668	1669	1670	1673	1676	1679	1686	1689	1690	1692	1695	1701	1706	1725	1726	1730	1739	1742	1743	1751	1755	1760	1761	1765	1767	1768	1771	1779	1781	1783	1787	1790	1795	1818	1825	1845	1850	1858	1861	1865	1870	1877	1878	1880	1887	1896	1907	1913	1916	1926	1945	1947	1948	1950	1959	1963	1967	1971	1976	1981	1984	1989	1992	1997	2009	2026	2029	2030	2031	2033	2046	2067	2068	2090	2103	2105	2108	2113	2118	2126	2128	2134	2138	2141	2151	2157	2158	2161	2176	2178	2186	2192	2194	2197	2201	2206	2219	2230	2240	2246	2271	2278	2284	2285	2289	2293	2304	2308	2319	2322	2333	
45	46	54	63	87	93	96	123	141	206	220	249	297	330	352	390	399	400	408	422	479	484	494	502	512	518	536	568	581	595	605	689	699	774	777	804	818	866	889	956	962	1002	1010	1017	1032	1063	1065	1089	1092	1099	1103	1129	1204	1214	1271	1282	1299	1343	1354	1361	1379	1402	1424	1426	1433	1461	1523	1561	1593	1628	1646	1685	1687	1693	1707	1713	1737	1746	1752	1769	1784	1797	1798	1872	1919	1935	1946	1953	1954	1969	1980	2006	2008	2017	2019	2023	2053	2058	2062	2069	2073	2092	2098	2099	2130	2135	2139	2155	2180	2204	2236	2247	2299	
3	4	5	6	22	25	28	32	34	40	52	55	69	74	79	91	98	111	113	115	117	127	140	153	157	158	165	170	173	174	178	179	185	190	192	196	211	215	223	235	245	246	247	253	266	296	300	306	310	311	315	324	327	328	331	346	349	372	379	391	435	441	454	461	464	472	473	501	514	524	545	547	550	562	567	570	572	574	575	584	604	606	612	617	620	626	629	632	636	638	642	643	656	662	673	685	695	702	704	708	710	714	715	735	751	754	760	772	776	784	787	790	794	796	801	805	806	814	817	823	826	827	836	839	841	848	862	897	900	902	907	919	926	927	928	931	932	934	935	944	951	958	971	972	974	975	988	1000	1006	1008	1014	1022	1026	1034	1037	1038	1039	1043	1064	1066	1071	1076	1087	1090	1093	1098	1108	1152	1153	1155	1160	1162	1164	1166	1167	1168	1175	1183	1187	1192	1206	1211	1216	1217	1228	1229	1233	1239	1241	1251	1252	1257	1258	1276	1289	1296	1298	1303	1306	1310	1315	1318	1322	1323	1329	1331	1332	1337	1348	1359	1360	1362	1364	1368	1378	1387	1390	1397	1398	1400	1418	1440	1443	1444	1454	1459	1462	1467	1468	1478	1497	1505	1507	1509	1512	1517	1518	1520	1532	1538	1540	1541	1558	1559	1562	1570	1576	1578	1583	1586	1596	1599	1600	1608	1611	1626	1653	1655	1656	1657	1665	1688	1702	1705	1714	1718	1727	1731	1732	1741	1749	1758	1762	1763	1772	1802	1811	1823	1827	1828	1831	1832	1833	1834	1838	1840	1847	1848	1852	1856	1869	1871	1882	1884	1890	1900	1902	1905	1914	1915	1925	1943	1944	1958	1962	1964	1973	1974	1978	1990	1993	1999	2013	2016	2018	2027	2032	2045	2050	2059	2061	2065	2078	2084	2087	2088	2107	2110	2119	2121	2127	2137	2149	2159	2162	2179	2190	2196	2199	2210	2228	2235	2238	2239	2241	2248	2251	2254	2255	2258	2261	2262	2263	2264	2269	2272	2277	2287	2288	2290	2294	2295	2309	2311	2320	2328	
11	16	27	35	38	59	60	66	76	83	97	107	114	119	120	134	135	149	152	162	166	167	188	203	205	207	219	229	241	242	258	259	262	265	267	279	291	307	318	342	351	353	360	367	370	401	403	416	417	420	421	425	436	439	443	447	448	451	460	468	471	476	480	485	488	492	499	500	504	506	510	515	523	529	530	538	551	553	557	565	580	583	598	602	624	640	650	652	653	661	669	674	677	678	680	688	697	707	734	745	749	752	755	758	763	766	767	768	779	786	791	800	803	807	828	838	845	856	879	880	882	884	895	898	910	911	915	917	924	925	938	939	950	953	961	973	982	1011	1013	1024	1042	1050	1052	1058	1059	1078	1083	1086	1111	1115	1118	1121	1122	1123	1127	1128	1133	1136	1137	1157	1159	1174	1190	1193	1194	1196	1201	1203	1205	1221	1227	1230	1237	1250	1254	1265	1267	1272	1277	1285	1286	1292	1295	1325	1328	1330	1347	1367	1370	1373	1375	1381	1388	1406	1407	1422	1423	1435	1436	1442	1451	1477	1487	1489	1501	1508	1516	1535	1552	1555	1565	1581	1585	1588	1590	1591	1603	1604	1618	1625	1627	1631	1637	1638	1640	1643	1663	1667	1694	1697	1708	1716	1717	1720	1729	1759	1775	1777	1800	1803	1806	1809	1810	1817	1822	1835	1839	1841	1846	1854	1855	1857	1863	1868	1875	1876	1881	1886	1888	1912	1917	1920	1921	1923	1929	1932	1939	1951	1966	1985	1988	1991	2012	2038	2041	2043	2048	2051	2055	2070	2086	2094	2095	2104	2109	2117	2120	2122	2133	2140	2142	2147	2148	2152	2168	2188	2205	2212	2214	2217	2223	2224	2229	2237	2243	2250	2265	2273	2297	2301	2302	2314	2336	
8	14	15	21	24	26	31	36	37	39	47	48	49	51	58	61	62	65	67	70	71	89	90	103	104	106	109	133	138	148	181	198	201	217	233	236	239	248	273	280	286	293	294	301	314	325	332	337	340	343	344	347	348	356	357	364	373	374	376	380	381	385	388	402	405	414	415	423	427	429	437	440	444	446	455	456	493	497	508	509	520	528	533	546	555	558	569	577	579	587	588	589	590	594	596	597	599	600	607	608	610	611	616	618	623	628	631	633	634	649	659	664	667	670	681	683	690	691	692	693	696	709	719	720	722	728	730	731	732	736	746	756	759	765	769	771	775	778	785	788	789	799	811	815	829	834	840	852	853	854	858	861	872	875	878	881	883	888	899	901	904	918	941	946	949	952	970	977	978	981	983	986	989	999	1012	1016	1029	1036	1040	1045	1048	1060	1062	1079	1082	1084	1095	1097	1100	1110	1112	1119	1120	1126	1131	1132	1138	1141	1143	1144	1148	1165	1176	1186	1197	1208	1213	1220	1223	1225	1248	1253	1261	1266	1268	1274	1278	1287	1291	1300	1305	1308	1309	1313	1320	1326	1339	1350	1351	1355	1357	1369	1374	1376	1377	1384	1386	1392	1404	1416	1419	1429	1432	1434	1441	1450	1457	1464	1465	1498	1503	1504	1510	1511	1521	1525	1528	1530	1531	1534	1542	1543	1544	1548	1549	1569	1571	1574	1575	1577	1579	1582	1594	1598	1606	1607	1615	1617	1621	1632	1633	1642	1654	1666	1672	1678	1681	1682	1698	1704	1711	1719	1736	1738	1754	1766	1770	1776	1782	1785	1791	1799	1805	1813	1824	1829	1842	1843	1844	1853	1873	1874	1889	1892	1903	1904	1908	1910	1911	1922	1934	1936	1938	1956	1965	1968	1975	1982	1983	1986	2007	2024	2028	2036	2042	2047	2054	2063	2064	2072	2075	2079	2080	2081	2082	2097	2102	2106	2114	2116	2123	2129	2131	2136	2143	2145	2156	2160	2164	2165	2166	2170	2174	2183	2185	2189	2193	2203	2207	2216	2220	2234	2244	2245	2257	2259	2270	2280	2298	2305	2306	2307	2313	2316	2321	2323	2324	2326	
1	10	12	33	41	57	68	78	82	85	88	92	95	100	101	128	129	130	131	154	159	161	163	164	171	191	194	204	210	213	214	221	224	227	228	231	250	252	255	256	269	282	283	287	290	292	295	299	302	304	308	309	313	316	320	322	323	329	335	345	350	355	368	377	383	384	386	387	394	404	406	407	411	413	418	424	430	431	433	438	445	453	457	465	474	475	477	478	481	491	495	498	521	522	540	542	548	554	571	627	635	645	647	654	671	676	686	687	698	705	713	723	739	742	743	747	750	764	793	798	813	816	821	824	837	844	846	847	849	850	859	867	874	885	887	892	893	894	896	906	908	909	914	921	937	942	948	954	959	968	979	987	993	996	997	1003	1005	1019	1020	1021	1031	1047	1049	1054	1067	1068	1077	1080	1081	1096	1102	1113	1124	1134	1149	1150	1158	1161	1163	1173	1177	1178	1180	1181	1182	1184	1191	1198	1215	1224	1235	1240	1242	1245	1255	1262	1293	1307	1335	1336	1341	1356	1366	1371	1385	1410	1414	1421	1428	1431	1446	1449	1452	1460	1469	1470	1474	1475	1486	1495	1500	1514	1524	1533	1537	1539	1546	1553	1560	1563	1564	1567	1572	1573	1584	1601	1602	1605	1610	1620	1636	1639	1645	1651	1652	1661	1662	1664	1674	1677	1680	1691	1710	1712	1715	1721	1722	1724	1733	1750	1753	1757	1764	1774	1778	1793	1794	1801	1804	1807	1812	1816	1820	1826	1836	1837	1860	1879	1885	1893	1895	1898	1899	1906	1927	1933	1940	1941	1942	1949	1952	1955	1957	1960	1961	1972	1979	1987	1996	1998	2001	2002	2003	2004	2005	2011	2014	2015	2020	2022	2034	2035	2039	2044	2052	2057	2060	2066	2071	2074	2083	2091	2093	2100	2111	2125	2132	2150	2153	2154	2163	2167	2169	2172	2173	2175	2181	2184	2187	2191	2198	2200	2202	2208	2221	2225	2226	2227	2231	2232	2249	2253	2266	2267	2274	2275	2279	2291	2292	2300	2303	2312	2318	2325	2329	2331	2332	2335	2338	
13	20	23	44	53	56	84	105	108	110	122	124	125	126	132	136	139	143	144	145	146	150	156	160	169	176	180	184	189	193	197	202	209	216	225	226	254	261	268	272	274	276	278	284	285	288	312	317	319	321	334	336	338	354	365	371	375	378	382	393	396	397	409	410	419	426	428	434	442	449	452	459	462	463	470	503	507	511	513	525	527	532	534	535	537	539	543	549	560	561	563	566	573	578	582	585	586	591	593	601	603	619	630	637	648	655	657	665	672	675	679	682	684	700	711	712	716	718	724	725	737	740	741	753	757	762	773	780	781	782	783	810	812	820	822	830	831	832	842	851	857	860	863	869	871	873	876	877	905	913	916	922	923	929	930	943	945	955	960	964	965	967	969	976	980	985	992	994	998	1001	1004	1007	1009	1015	1023	1028	1030	1035	1044	1053	1055	1057	1070	1073	1075	1085	1088	1109	1135	1139	1146	1151	1188	1189	1200	1202	1209	1210	1212	1222	1231	1234	1238	1243	1244	1256	1259	1260	1264	1270	1273	1279	1281	1283	1288	1290	1294	1297	1301	1304	1311	1312	1314	1327	1333	1334	1338	1344	1345	1346	1349	1353	1358	1363	1380	1394	1395	1396	1405	1408	1409	1412	1413	1415	1417	1420	1430	1438	1456	1471	1473	1476	1483	1484	1488	1493	1494	1506	1526	1527	1529	1545	1551	1554	1556	1566	1587	1597	1614	1616	1624	1629	1630	1641	1644	1649	1650	1658	1671	1675	1683	1684	1696	1699	1700	1703	1709	1723	1728	1734	1735	1740	1744	1745	1747	1748	1756	1773	1780	1786	1788	1789	1792	1796	1808	1814	1815	1819	1821	1830	1849	1851	1859	1862	1864	1866	1867	1883	1891	1894	1897	1901	1909	1918	1924	1928	1930	1931	1937	1970	1977	1994	1995	2000	2010	2021	2025	2037	2040	2049	2056	2076	2077	2085	2089	2096	2101	2112	2115	2124	2144	2146	2171	2177	2182	2195	2209	2211	2213	2215	2218	2222	2233	2242	2252	2256	2260	2268	2276	2281	2282	2283	2286	2296	2310	2315	2317	2327	2330	2334	2337	
