5	10	14	27	29	39	45	48	50	53	55	57	58	64	67	70	92	97	99	100	101	108	109	111	112	114	116	118	119	128	130	131	134	136	140	149	150	152	156	165	173	176	177	181	186	191	197	198	201	206	209	214	221	222	224	225	227	229	232	233	236	239	240	246	249	258	262	264	269	276	281	287	288	294	300	301	308	319	320	322	324	328	337	338	342	343	346	348	354	357	365	370	375	381	382	385	397	398	405	411	412	417	421	423	433	436	437	448	453	455	456	473	477	478	483	486	487	491	494	502	504	505	509	510	518	520	524	531	534	550	556	559	560	562	568	569	572	574	582	584	600	604	619	621	623	624	627	630	634	637	644	652	654	656	657	658	659	661	670	678	679	681	684	690	695	701	703	707	718	719	727	729	739	744	761	764	765	776	795	805	818	823	829	831	840	853	855	864	868	869	875	881	888	893	898	900	901	906	921	929	934	936	941	946	950	959	964	968	971	972	975	981	994	995	997	1002	1005	1010	1017	1018	1019	1021	1030	1031	1035	1039	1041	1043	1046	1051	1072	1075	1077	1078	1086	1092	1102	1107	1109	1112	1120	1129	1134	1138	1142	1143	1148	1155	1164	1167	1171	1175	1177	1180	1186	1188	1190	1191	1198	1199	1202	1203	1205	1208	1214	1215	1216	1219	1229	1230	1231	1234	1235	1238	1239	1248	1253	1255	1259	1265	1273	1288	1301	1305	1314	1318	1322	1323	1333	1337	1340	1345	1347	1350	
2	6	8	15	30	36	41	46	47	65	66	82	83	87	88	95	113	115	122	123	127	129	141	145	146	148	151	163	164	168	172	174	183	220	228	230	234	241	245	247	248	255	257	263	265	273	274	280	283	304	309	323	330	335	347	351	374	376	379	383	387	388	390	391	394	403	420	426	428	430	431	438	439	451	454	457	460	468	471	474	481	482	485	490	499	500	503	506	517	522	525	532	539	546	549	561	563	581	589	593	595	596	597	601	607	608	611	618	632	636	638	645	650	660	662	664	665	677	685	691	709	717	722	723	726	732	733	762	763	791	794	797	800	801	804	815	824	833	834	835	837	841	854	859	880	885	886	907	916	922	924	942	944	948	956	966	974	978	980	986	987	989	990	1000	1001	1003	1004	1008	1022	1036	1042	1047	1049	1053	1054	1056	1069	1070	1088	1089	1095	1099	1105	1110	1116	1131	1132	1135	1137	1153	1154	1157	1161	1165	1168	1169	1172	1174	1195	1201	1212	1228	1236	1237	1242	1252	1258	1261	1269	1278	1285	1287	1290	1295	1297	1302	1310	1313	1319	1326	1334	1339	1343	1346	1349	
3	12	18	19	22	26	31	33	34	42	43	51	56	59	60	71	72	73	79	80	81	84	94	96	105	125	133	137	138	144	153	155	157	160	171	179	193	194	195	202	203	207	208	217	219	223	231	235	250	253	259	268	271	275	279	282	292	310	313	314	315	316	327	349	352	353	355	359	371	377	395	401	402	404	414	415	422	424	427	432	442	443	447	458	480	515	516	519	530	536	540	545	551	553	566	578	594	598	602	609	614	617	629	633	639	642	647	651	666	674	680	682	698	700	702	720	725	737	738	745	746	748	751	752	754	768	770	773	778	780	783	787	790	793	798	799	808	810	812	813	817	820	821	843	845	847	850	852	856	862	863	867	870	876	878	879	883	889	912	915	918	920	927	928	935	938	943	952	957	963	967	979	992	1016	1026	1027	1050	1055	1058	1059	1061	1062	1063	1080	1094	1101	1103	1108	1113	1114	1117	1119	1122	1126	1141	1149	1151	1156	1163	1166	1181	1187	1194	1204	1206	1207	1213	1217	1220	1232	1241	1251	1254	1266	1268	1271	1274	1279	1280	1292	1294	1298	1299	1306	1309	1316	1317	1320	1321	1328	1336	1341	
4	7	9	13	16	21	25	32	35	38	44	52	61	62	63	68	69	74	75	86	89	90	93	102	104	106	107	110	117	120	121	124	126	132	135	142	147	158	159	161	169	185	188	192	199	200	205	210	213	215	237	238	242	244	251	252	254	260	266	267	270	272	291	293	295	302	306	307	311	312	331	332	336	339	340	356	360	363	364	367	372	378	384	389	392	400	408	410	416	429	440	441	449	450	452	459	463	470	475	492	493	498	511	512	513	514	527	535	538	543	544	547	548	552	554	555	557	567	570	571	576	579	580	586	587	590	592	605	606	613	622	625	631	641	646	648	649	653	671	672	675	686	687	688	693	696	697	704	705	706	708	710	721	724	728	735	743	747	749	753	759	760	771	775	809	816	819	825	832	838	839	844	848	849	857	858	871	874	887	890	891	896	902	904	905	908	910	925	930	940	953	955	958	970	977	982	983	988	998	1006	1014	1023	1024	1032	1033	1034	1045	1057	1073	1079	1082	1084	1091	1093	1111	1115	1118	1124	1125	1127	1130	1136	1144	1146	1150	1159	1160	1162	1179	1182	1183	1185	1189	1193	1218	1221	1222	1225	1227	1233	1240	1243	1245	1246	1249	1250	1260	1264	1270	1277	1282	1284	1296	1303	1307	1312	1324	1327	1344	1348	
1	17	23	37	54	78	85	103	162	166	167	170	184	204	212	216	218	256	286	289	290	297	298	299	303	317	318	321	325	329	333	334	344	345	350	358	366	369	380	393	396	399	406	407	409	419	446	461	462	464	465	466	469	472	476	479	484	489	495	501	507	521	523	537	541	565	575	577	585	603	610	612	616	628	635	640	643	655	663	667	668	669	673	676	689	694	711	713	716	731	734	740	741	742	755	756	757	766	767	769	774	781	782	784	788	806	807	814	822	826	827	828	830	836	846	851	860	861	865	877	882	884	897	899	911	913	914	917	919	923	926	945	947	951	960	962	973	991	993	996	999	1007	1009	1011	1012	1015	1020	1025	1040	1048	1060	1066	1067	1074	1076	1081	1083	1098	1104	1123	1128	1133	1147	1192	1196	1197	1210	1223	1226	1244	1276	1283	1300	1304	1325	1331	1338	
20	24	28	98	178	180	189	190	243	278	296	326	341	386	467	508	526	528	558	564	583	615	683	692	714	772	786	789	811	842	873	903	931	954	961	984	985	1013	1028	1029	1037	1044	1065	1068	1087	1100	1106	1121	1173	1178	1184	1224	1256	1263	1275	1281	1293	1308	1311	1330	1335	
11	40	49	76	77	91	139	143	154	175	182	187	196	211	226	261	277	284	285	305	361	362	368	373	413	418	425	434	435	444	445	488	496	497	529	533	542	573	588	591	599	620	626	699	712	715	730	736	750	758	777	779	785	792	796	802	803	866	872	892	894	895	909	932	933	937	939	949	965	969	976	1038	1052	1064	1071	1085	1090	1096	1097	1139	1140	1145	1152	1158	1170	1176	1200	1209	1211	1247	1257	1262	1267	1272	1286	1289	1291	1315	1329	1332	1342	
