6 8 23 25 31 32 43 45
3 10 11 12 18 19 20 21 26 30 35 40 41 44 49
1 7 9 13 14 15 22 24 27 29 34 36 37 39 47
2 4 5 16 17 28 33 38 42 46 48 50
51 52 53 54 55 56 57 58
59 60 61 62 63 64 65 66
