6	18	30	36	38	40	51	52	55	58	87	97	117	123	128	132	135	141	146	
5	10	11	24	26	31	41	46	47	49	54	60	64	70	71	77	82	84	88	90	95	107	109	110	112	113	125	129	134	140	142	143	148	
4	9	15	17	20	29	32	34	35	39	50	62	66	67	75	78	80	85	99	100	102	105	106	111	121	127	133	138	145	
3	8	12	14	16	22	23	27	37	44	48	53	56	57	59	61	65	83	86	89	94	96	98	103	104	108	114	116	118	120	122	124	130	131	137	139	147	149	
1	2	7	13	19	21	25	28	33	42	43	45	63	68	69	72	73	74	76	79	81	91	92	93	101	115	119	126	136	144	150	
