9 14 17 28 32 34 42 50 52 57 64 67 69 81 90 95 109 111 117 124 125 126 131 139 141 147 151 160 194 214 224 236 251 259 273 277 289 304 305 307 309 313 326 329 332 338 342 345 357 361 362 391 394 405 428 434 442 445 456 458 462 463 469 470 475 490 503 507 514 516 519 537 540 547 550 553 560 561 574 586 599 607 608 613 632 640 644 646 650 652 666 669 676 681 692 696 701 712 727 728 733 739 753 772 781 783 828 844 852 863 869 873 885 898 903 904 924 927 929 931 932 942 950 956 961 963 977 986 987 996 997 999 1001 1003 1004 1005 1007 1011 1018 1029 1032 1033 1052 1060 1062 1063 1064 1065 1072 1073 1078 1079 1082 1083 1089 1109 1126 1128 1139 1146 1147 1151 1153 1163 1166 1167 1168 1178 1187 1196 1197 1211 1217 1229 1238 1240 1242 1265 1268 1273 1274 1277 1287 1294 1302 1310 1313 1317 1330 1337 1349
6 30 36 73 74 78 82 84 86 106 118 120 135 140 144 153 183 189 192 198 213 217 223 227 244 254 257 268 275 292 314 315 319 324 331 337 339 340 343 346 351 363 364 392 395 398 399 401 414 417 420 427 435 443 448 489 495 515 523 529 530 545 551 559 579 584 589 604 606 612 619 622 624 633 634 635 642 648 660 662 663 682 710 744 749 757 762 766 770 800 817 824 831 833 838 848 862 865 871 877 889 906 911 913 918 928 948 957 970 975 985 988 991 1014 1024 1030 1048 1055 1059 1070 1071 1074 1085 1086 1102 1103 1110 1111 1134 1156 1169 1172 1181 1193 1198 1243 1246 1253 1260 1269 1285 1291 1314 1325 1333 1335
3 4 43 49 58 62 70 75 85 92 97 112 129 137 148 154 162 165 187 199 202 218 225 226 231 240 249 267 280 284 285 296 298 308 311 318 356 358 365 384 393 406 407 411 413 421 425 438 439 441 446 447 451 454 465 467 468 491 498 502 520 527 528 532 533 557 570 577 578 580 585 590 594 598 605 611 617 625 631 636 671 697 707 709 717 719 721 730 732 750 759 773 775 777 778 779 780 788 796 801 806 815 816 830 832 837 839 845 850 854 861 886 887 888 897 901 910 923 925 930 935 936 945 958 960 967 983 990 1010 1013 1022 1025 1040 1041 1053 1057 1067 1069 1099 1117 1118 1123 1124 1130 1132 1144 1148 1152 1154 1159 1180 1189 1192 1199 1218 1224 1230 1244 1245 1263 1270 1275 1286 1297 1318 1327 1329 1334 1338 1341 1343 1345
18 21 27 33 37 38 54 55 59 83 93 96 99 100 110 113 116 121 123 127 134 142 145 161 166 167 168 181 182 185 193 201 206 208 210 212 215 220 230 232 233 238 256 258 271 272 282 287 288 312 317 334 341 360 369 372 374 378 379 380 389 396 403 412 415 416 418 419 422 423 430 460 466 471 472 477 478 481 486 492 493 496 500 504 505 517 526 546 549 552 572 576 587 596 597 600 601 610 614 616 618 620 621 630 639 651 653 655 656 673 683 687 688 706 708 711 713 714 720 722 723 724 725 726 731 735 736 740 742 743 755 761 763 764 771 785 792 793 794 797 803 804 807 808 811 818 823 826 836 842 843 846 857 867 880 884 891 892 917 954 968 974 981 992 993 994 995 1000 1002 1012 1019 1023 1035 1036 1039 1049 1056 1058 1061 1066 1075 1077 1084 1088 1094 1108 1122 1127 1150 1158 1160 1170 1177 1179 1188 1200 1204 1209 1216 1219 1228 1233 1235 1247 1257 1264 1278 1288 1292 1296 1301 1322 1328 1339 1347
1 2 11 12 15 16 20 23 29 31 39 41 44 45 56 68 71 72 79 80 89 103 105 108 114 119 128 133 143 146 149 150 155 156 157 159 170 171 172 174 175 179 190 195 197 204 205 211 219 221 228 234 239 242 243 246 248 252 253 255 265 270 274 278 279 281 299 301 303 327 330 335 344 352 355 367 368 371 375 376 377 381 382 386 397 400 408 409 431 432 433 450 455 457 464 474 476 479 480 483 484 487 494 497 509 510 511 518 535 536 538 542 543 554 563 571 573 581 582 583 588 592 593 595 615 623 638 643 645 659 665 667 670 685 686 689 690 695 700 703 704 716 729 737 745 747 751 752 756 774 782 787 790 799 809 810 812 813 819 820 821 834 841 849 858 859 860 864 866 870 878 879 882 896 899 900 902 907 909 914 915 926 934 949 952 962 964 966 971 973 982 984 989 1015 1016 1017 1026 1027 1028 1034 1038 1044 1045 1068 1076 1080 1096 1100 1107 1113 1114 1121 1129 1140 1145 1149 1155 1161 1164 1174 1175 1182 1190 1195 1201 1206 1207 1214 1225 1227 1236 1237 1248 1251 1256 1258 1276 1279 1283 1284 1295 1298 1309 1311 1312 1319 1324 1336 1340 1342
7 24 40 46 48 51 53 65 87 91 94 98 102 107 115 122 130 169 173 184 186 188 191 209 235 247 250 264 266 269 276 286 291 295 306 321 322 336 350 366 370 385 390 404 426 437 453 459 506 513 521 522 534 556 562 565 568 591 628 637 641 647 649 658 661 664 672 674 677 678 679 680 702 738 746 765 768 776 784 795 802 827 847 855 856 868 875 876 890 894 895 905 908 916 921 937 939 940 941 943 951 969 972 978 980 998 1008 1009 1020 1037 1050 1081 1101 1105 1106 1115 1116 1120 1125 1131 1133 1143 1171 1173 1176 1183 1191 1202 1203 1205 1208 1210 1215 1222 1231 1234 1239 1241 1267 1272 1280 1281 1289 1290 1293 1299 1300 1306 1315 1316 1332 1344 1348 1350
5 8 10 13 19 22 25 26 35 47 60 61 63 66 76 77 88 101 104 132 136 138 152 158 163 164 176 177 178 180 196 200 203 207 216 222 229 237 241 245 260 261 262 263 283 290 293 294 297 300 302 310 316 320 323 325 328 333 347 348 349 353 354 359 373 383 387 388 402 410 424 429 436 440 444 449 452 461 473 482 485 488 499 501 508 512 524 525 531 539 541 544 548 555 558 564 566 567 569 575 602 603 609 626 627 629 654 657 668 675 684 691 693 694 698 699 705 715 718 734 741 748 754 758 760 767 769 786 789 791 798 805 814 822 825 829 835 840 851 853 872 874 881 883 893 912 919 920 922 933 938 944 946 947 953 955 959 965 976 979 1006 1021 1031 1042 1043 1046 1047 1051 1054 1087 1090 1091 1092 1093 1095 1097 1098 1104 1112 1119 1135 1136 1137 1138 1141 1142 1157 1162 1165 1184 1185 1186 1194 1212 1213 1220 1221 1223 1226 1232 1249 1250 1252 1254 1255 1259 1261 1262 1266 1271 1282 1303 1304 1305 1307 1308 1320 1321 1323 1326 1331 1346
1351 1352 1353 1354 1355 1356 1357 1358 1359 1360 1361 1362 1363 1364 1365 1366
