4 6 8 12 22 24 29 34 39 41 42 45 48 50 51 53 55 57 59 61 62 70 73 74 80 87 91 100 104 105 106 111 114 122 123 124 130 131 142 145 149
3 5 9 13 19 21 26 31 36 63 65 67 68 77 83 85 97 98 119 126 133 137 139 141
7 33 35 37 44 54 64 78 82 86 88 94 95 96 103 107 109 115 116 117 121 125 128 132
1 11 14 15 23 25 32 43 58 66 69 71 75 84 90 108 110 138 140 144 148
2 16 17 18 20 27 28 38 40 46 56 60 72 79 81 93 99 101 113 118 120 127 129 134 136 146
10 30 47 49 52 76 89 92 102 112 135 143 147 150
151 152 153 154 155 156 157 158 159 160 161 162 163 164 165 166
