7 11 12 20 22 25 28 30 33 52 64 77 111 127 133 137 143 145 151 153 160 161 166 177 186 189 192 204 206 208 211 212 216 220 221 227 230 241 243 252
1 31 37 40 41 47 60 66 72 75 85 92 96 101 106 110 112 121 123 132 135 136 152 158 168 183 184 185 190 195 198 205 222 223 255
2 3 13 15 24 27 39 43 45 50 53 54 59 65 67 69 71 78 84 88 98 100 104 109 113 122 125 130 131 141 144 147 154 155 156 157 165 170 176 178 187 193 196 199 201 203 209 215 224 229 231 232 233 246 248 249 250 253 254 257 259
48 51 82 97 102 115 117 119 128 139 148 150 172 179 247 251
18 19 23 26 29 35 38 42 44 55 63 70 73 80 81 83 86 89 94 95 105 107 108 116 118 120 124 129 134 138 140 142 146 162 163 171 180 182 188 194 197 210 225 226 228 235 236 238 239 242 244 245 256 258 260
4 5 6 8 9 10 14 16 17 21 32 34 36 46 49 56 57 58 61 62 68 74 76 79 87 90 91 93 99 103 114 126 149 159 164 167 169 173 174 175 181 191 200 202 207 213 214 217 218 219 234 237 240
