10 11 12 18 28 29 35 38 40 57 68 69 77 86 90 93 97 98 106 128 130 133 134 136 149 155 158 165 174 175 177 182 197 200 203 214 227 240 242 244 245 251 252 253 266 268 271 277 282 289 292 296 297 315 319 323 328 332 333 335 337 345 352 355 359 366 371 383 387 391 392 396 406 424 425 426 441 447 455 459 471 480 483 484 486 501 503 508 516 521 522 526 541 551 552 558 560 571 577 579 582 585 601 605 619 623 626 647 667 670 671 685 686 694 699 702 703 706 710 717 720 722 725 728 731 732 744 752 757 758 765 770 776 779
9 47 53 71 79 85 92 100 102 124 127 137 140 164 166 170 186 188 189 191 229 230 231 238 239 250 255 259 276 294 301 305 306 307 308 318 320 331 339 356 367 377 380 384 397 408 420 423 428 435 438 458 463 467 473 477 492 506 509 524 532 556 561 580 583 584 597 602 603 608 611 620 631 640 642 651 660 666 669 677 679 682 690 697 704 705 712 718 734 735 740 746 759 763 772 775 777
1 3 19 24 41 54 62 66 67 88 108 115 119 120 135 138 148 151 162 167 171 190 193 198 199 206 207 223 226 247 260 263 272 274 278 298 303 312 324 340 342 346 348 351 363 378 382 404 407 411 422 432 448 468 478 490 494 498 519 529 537 549 562 566 581 590 594 606 612 613 634 638 643 645 646 655 659 665 675 676 681 693 695 707 713 715 726 738 741 751
7 27 32 49 52 75 76 78 81 91 101 105 110 112 117 132 141 147 157 173 180 183 194 204 211 212 215 218 220 221 241 243 258 264 265 267 269 270 273 279 288 293 302 313 317 325 334 344 360 398 400 415 416 439 446 457 461 472 475 487 496 500 513 514 520 525 528 531 533 535 536 540 542 543 546 557 564 575 598 600 614 618 629 630 633 652 653 683 691 709 721 723 724 733 749 755 762 768 771
2 4 13 17 20 22 25 26 30 31 36 43 45 46 48 51 55 56 61 65 84 95 96 103 107 113 116 121 129 131 143 144 146 150 154 159 160 163 169 172 176 187 192 202 219 224 233 235 237 246 249 254 283 286 295 299 300 310 316 321 329 357 364 365 372 375 385 386 388 393 394 395 399 402 410 414 430 434 436 437 440 442 450 454 460 464 465 469 479 489 491 493 495 499 502 504 505 515 530 534 538 544 548 555 567 568 573 576 591 593 607 625 637 639 641 644 648 649 654 661 662 663 674 678 688 689 692 698 700 711 716 729 739 742 745 750 753 756 766 773 774
14 23 44 59 64 70 82 83 87 89 94 109 122 139 152 153 156 168 179 185 195 196 201 209 210 222 225 228 232 234 236 256 262 284 285 287 290 291 314 330 343 347 361 362 370 376 381 389 390 409 413 427 431 433 443 444 445 449 451 452 453 462 466 474 476 481 482 485 488 507 511 512 517 518 559 570 578 586 588 592 599 604 609 615 617 621 622 628 650 658 668 673 680 687 696 701 708 714 719 727 730 736 737 747 764 767 769 778
5 6 8 15 16 21 33 34 37 39 42 50 58 60 63 72 73 74 80 99 104 111 114 118 123 125 126 142 145 161 178 181 184 205 208 213 216 217 248 257 261 275 280 281 304 309 311 322 326 327 336 338 341 349 350 353 354 358 368 369 373 374 379 401 403 405 412 417 418 419 421 429 456 470 497 510 523 527 539 545 547 550 553 554 563 565 569 572 574 587 589 595 596 610 616 624 627 632 635 636 656 657 664 672 684 743 748 754 760 761
780 781 782 783 784 785 786 787 788 789 790 791 792 793 794 795
