13 18 22 51 57 68 72 73 107 123 130 144 146 152 176 178 183 190 197 200 209 214 216 221 237
37 47 58 60 70 75 76 78 86 89 91 99 102 105 111 113 138 147 159 173 179 181 187 198 201 218 224 229 231 233 243 246 249 252 255 258
4 9 23 24 38 39 40 42 55 65 71 80 84 90 92 94 98 114 117 122 126 128 139 206 211 232 235 236 238 242 244 251 253 260
2 8 25 26 31 52 61 62 64 97 100 131 141 150 164 169 170 174 175 203 213 219 223 226 234 239 259
3 5 12 15 17 28 30 34 36 41 43 49 50 63 77 79 82 87 88 95 101 103 109 116 118 121 129 136 142 145 156 158 162 165 168 177 188 191 194 195 204 217 225 227 228 240 245 254 257
6 7 16 20 27 33 45 46 53 59 69 74 81 110 112 119 125 127 135 137 140 151 153 154 155 160 161 166 167 171 180 182 192 196 199 202 212 220 241 247
1 10 11 14 19 21 29 32 35 44 48 54 56 66 67 83 85 93 96 104 106 108 115 120 124 132 133 134 143 148 149 157 163 172 184 185 186 189 193 205 207 208 210 215 222 230 248 250 256
261 262 263 264 265 266 267 268 269 270 271 272 273 274 275 276
