5 11 13 14 16 24 48 50 52 54 57 65 66 68 71 84 121 124 130 131 132 152 155 165 178 179 190 191 200 202 207 218 222 223 224 229 230 231 232 237 243 258
2 6 15 21 28 33 34 37 53 64 69 74 75 76 88 90 97 101 104 129 139 141 147 150 158 168 170 171 176 184 198 199 201 203 204 205 208 209 215 221 228 241 250 252 259
1 7 20 22 23 27 32 36 38 43 45 47 49 58 59 62 63 82 111 113 117 122 123 126 133 134 136 137 140 145 149 151 153 154 157 159 160 161 166 182 186 193 195 196 211 212 219 220 226 227 234 235 239 242 246 248 249 253
12 18 19 26 29 35 40 42 44 51 55 67 70 73 78 80 81 86 89 94 98 100 105 107 108 116 118 119 120 125 128 135 138 142 146 156 162 163 180 183 185 188 194 197 210 217 225 236 238 244 245 247 251 256 257 260
3 4 8 9 10 17 25 30 31 39 41 46 56 60 61 72 77 79 83 85 87 91 92 93 95 96 99 102 103 106 109 110 112 114 115 127 143 144 148 164 167 169 172 173 174 175 177 181 187 189 192 206 213 214 216 233 240 254 255
261 262 263 264 265 266 267 268 269 270 271 272 273 274 275 276
