36 38 41 52 54 55 59 64 72 81 87 92 98 103 107 108 111 117 118 120 121 146
6 11 18 22 26 29 30 31 43 44 46 47 56 58 60 62 73 75 78 79 82 85 88 90 95 96 102 105 114 119 123 129 133 134 135 136 141 142 143 145
1 5 13 19 33 42 45 51 63 68 70 84 99 101 109 113 122 138 147 148 150
3 8 12 14 15 16 23 27 37 40 48 53 57 65 69 74 76 77 80 83 89 91 93 94 97 100 106 110 112 115 116 124 125 126 128 131 132 137 144
2 4 7 9 10 17 20 21 24 25 28 32 34 35 39 49 50 61 66 67 71 86 104 127 130 139 140 149
151 152 153 154 155 156 157 158 159 160 161 162 163 164 165 166
