9 10 26 31 32 34 35 39 42 43 48 50 58 59 60 66 71 80 83 89 92 94 102 118 127 133 134 137 141 142 155 157 162 174 178 186 188 193 195 196 203 208 211 212 222 227 249 251 255 259 260 263 269 271 281 285 293 295 309 319 328 344 351 365 383 385 388 392 393 397 400 402 403 404 407 411 412 414 421 436 437 438 450 454 461 468 469 479 485 487 496 503 531 540 542 553 559 564 584 586 592 602 613 614 621 625 644 656 667 674 675 678 687 694 695 697 699 702 704 705 709 719 721 722 723 729 735 743 745 760 807 810 819 823 825 829 833 835 838 843 850 856 861 862 863 864 870 886 888 892 893 897 902 915 918 928 933 950 952 958 959 970 972 981 983 992 998 1008 1012 1018 1019 1021 1027 1032 1034 1042 1045 1046 1052 1063 1074 1075 1084 1091 1107 1108 1109 1114 1119 1120 1128 1131 1145 1148 1154 1160 1166 1181 1184 1199 1200 1205 1225 1228 1233 1242 1246 1247 1259 1261 1276 1278 1281 1297 1298 1320 1321 1329 1341 1351 1355 1381 1384 1396 1404 1409 1411 1423 1426 1432 1440 1448 1449 1451 1458 1459 1475 1482 1483 1484 1487 1488 1491 1494 1500 1513 1517 1540 1544 1555 1570 1571 1577 1587 1591 1598 1602 1618 1622 1638 1648 1649 1653 1663 1665 1669 1673 1679 1682 1685 1687 1698 1699 1701 1729 1738 1743 1749 1756 1764 1765 1794 1798 1801 1809 1818 1823 1825 1837 1842 1844 1852 1858 1868 1876 1877 1878 1888 1894 1899 1904 1925 1928 1947 1971 1982 1983 1992 1996 1999 2008 2009 2015 2024 2036 2040 2042 2062 2065 2067 2072 2073 2082 2086 2090 2091 2094 2095 2096 2097 2103 2111 2114 2116 2121 2124 2128 2144 2154 2168 2170 2176 2186 2187 2194 2196 2222 2223 2237 2239 2243 2246 2251 2266 2275 2279 2289 2299 2302 2306 2314 2322 2338
1 3 12 17 24 28 30 40 41 51 54 64 69 73 79 81 86 88 93 109 111 116 117 120 135 143 148 164 165 166 167 168 180 184 189 200 206 207 213 230 238 246 250 264 265 267 274 292 294 297 310 311 317 322 333 356 357 372 380 391 395 417 424 440 455 456 464 473 484 490 505 506 512 514 520 528 549 550 575 580 585 591 594 609 615 620 622 624 626 638 650 668 676 679 683 688 706 707 715 716 746 757 758 781 782 784 787 792 801 815 816 824 830 839 884 885 894 899 914 917 919 935 939 940 957 960 980 990 1004 1037 1039 1047 1065 1067 1085 1087 1088 1092 1105 1122 1123 1124 1127 1135 1139 1155 1158 1165 1173 1183 1187 1189 1197 1203 1204 1206 1211 1216 1217 1223 1227 1237 1250 1251 1262 1270 1271 1275 1288 1303 1304 1305 1306 1311 1315 1317 1318 1323 1336 1342 1345 1363 1364 1368 1369 1373 1392 1402 1407 1412 1413 1415 1420 1424 1443 1454 1476 1481 1489 1497 1501 1505 1506 1507 1520 1526 1535 1550 1558 1578 1584 1585 1600 1608 1617 1631 1637 1646 1655 1656 1657 1664 1670 1672 1675 1686 1696 1708 1709 1725 1727 1731 1734 1740 1747 1750 1752 1783 1793 1803 1808 1811 1812 1815 1831 1838 1841 1850 1857 1880 1884 1897 1902 1905 1906 1907 1912 1931 1937 1943 1952 1961 1964 1966 1975 1988 1989 1993 2004 2018 2020 2021 2022 2029 2035 2049 2051 2053 2059 2066 2068 2083 2087 2102 2104 2105 2110 2126 2150 2158 2161 2162 2163 2164 2166 2173 2184 2188 2202 2205 2206 2213 2229 2244 2252 2258 2261 2262 2269 2284 2288 2301 2308 2324 2328 2331 2332
15 16 20 21 38 44 61 63 65 67 68 70 82 87 101 113 121 140 145 153 154 161 169 175 197 202 205 220 226 234 239 242 256 258 268 272 300 301 303 304 307 312 314 323 332 334 337 342 348 350 359 363 381 387 399 401 408 420 422 441 446 447 462 465 471 474 482 500 502 508 509 510 513 533 536 537 544 552 562 570 572 573 574 577 582 588 590 595 605 606 607 616 618 627 637 649 651 652 655 657 658 664 665 670 681 684 690 693 713 726 730 732 733 736 740 741 744 756 765 776 778 785 788 789 791 803 808 813 814 817 820 826 828 834 842 845 846 848 849 854 866 868 873 875 879 882 895 901 904 907 913 916 934 936 938 946 947 962 965 971 979 985 986 996 997 999 1000 1002 1011 1013 1016 1049 1051 1055 1059 1060 1064 1071 1073 1079 1082 1083 1086 1093 1095 1103 1110 1116 1117 1125 1129 1140 1143 1146 1162 1171 1177 1179 1186 1192 1198 1208 1210 1220 1222 1224 1239 1253 1258 1269 1284 1290 1292 1296 1302 1309 1316 1325 1326 1331 1332 1334 1339 1348 1353 1357 1358 1359 1362 1390 1391 1399 1405 1417 1429 1430 1435 1441 1450 1463 1473 1480 1493 1499 1519 1521 1523 1541 1543 1552 1553 1556 1557 1559 1565 1568 1569 1573 1579 1583 1589 1595 1596 1604 1609 1611 1627 1628 1630 1634 1642 1643 1645 1647 1652 1658 1666 1671 1678 1680 1683 1684 1693 1707 1710 1713 1715 1718 1722 1723 1730 1736 1737 1748 1759 1772 1776 1778 1781 1786 1787 1791 1792 1802 1810 1814 1817 1821 1827 1828 1829 1851 1853 1859 1860 1866 1869 1879 1882 1885 1887 1889 1890 1891 1908 1915 1916 1918 1926 1933 1940 1949 1950 1955 1973 1978 1979 1991 1995 2003 2006 2026 2031 2043 2045 2048 2052 2061 2069 2074 2077 2084 2100 2106 2113 2115 2117 2118 2130 2139 2143 2146 2165 2177 2178 2180 2183 2191 2192 2197 2203 2204 2207 2211 2212 2215 2218 2225 2228 2250 2259 2260 2265 2277 2278 2282 2286 2300 2311 2334 2337
5 6 8 14 29 33 36 37 47 49 55 56 78 91 96 100 107 108 119 123 124 129 130 139 149 151 156 160 163 170 171 179 181 182 183 185 187 194 210 224 225 231 235 240 241 243 247 248 257 266 270 277 282 286 291 298 308 318 320 330 331 341 343 347 355 358 364 371 373 390 394 409 410 425 427 448 453 458 467 470 472 491 493 497 521 524 525 527 529 541 545 546 551 554 555 556 563 565 569 579 587 593 596 599 600 610 623 628 631 634 635 641 662 671 680 685 689 691 696 708 712 725 739 750 751 767 768 771 773 774 775 780 790 795 798 805 812 821 827 840 841 847 852 871 872 874 878 889 896 898 908 912 921 923 927 941 943 945 951 953 966 967 968 975 984 1003 1017 1020 1031 1054 1056 1057 1066 1068 1076 1078 1081 1094 1097 1099 1102 1104 1112 1126 1130 1132 1138 1141 1150 1152 1156 1161 1164 1190 1191 1195 1202 1214 1215 1218 1234 1245 1260 1265 1266 1267 1273 1274 1293 1294 1299 1308 1330 1335 1338 1340 1344 1360 1365 1370 1371 1377 1378 1397 1400 1401 1403 1414 1416 1421 1431 1433 1434 1438 1442 1444 1452 1462 1465 1466 1467 1472 1478 1485 1495 1496 1502 1503 1508 1511 1518 1524 1528 1529 1530 1532 1533 1534 1545 1546 1548 1561 1562 1564 1567 1575 1576 1593 1594 1599 1605 1607 1610 1621 1636 1661 1668 1674 1676 1677 1702 1721 1739 1742 1744 1746 1751 1753 1769 1779 1780 1782 1784 1785 1788 1795 1797 1799 1800 1807 1826 1832 1835 1836 1843 1846 1849 1856 1861 1863 1892 1895 1898 1903 1910 1911 1921 1934 1936 1941 1946 1948 1962 1969 1977 1981 1997 1998 2010 2012 2016 2025 2033 2050 2056 2063 2085 2088 2112 2119 2120 2123 2136 2140 2145 2147 2149 2151 2152 2159 2160 2175 2179 2198 2216 2217 2220 2227 2230 2240 2242 2245 2248 2249 2257 2270 2273 2281 2283 2287 2292 2293 2294 2304 2310 2319 2335
2 4 7 11 13 22 25 27 52 53 57 62 74 75 76 77 85 103 104 105 110 112 115 125 128 138 159 172 173 176 198 199 201 204 215 218 219 221 223 228 229 232 236 237 253 254 261 276 278 279 280 284 290 299 306 316 327 340 346 349 353 354 360 361 362 366 367 374 375 396 406 413 415 416 431 439 442 443 445 449 451 457 459 460 463 466 475 478 481 483 488 489 507 511 515 516 517 526 532 558 566 583 598 603 608 612 617 619 629 630 632 633 636 639 642 645 648 661 663 673 692 698 720 731 734 738 742 748 754 755 759 761 762 769 796 797 799 800 806 809 811 836 837 855 858 867 880 881 903 906 920 925 930 932 948 949 956 961 963 969 995 1005 1006 1010 1015 1022 1024 1025 1026 1028 1029 1033 1036 1040 1041 1048 1053 1069 1070 1072 1098 1100 1106 1118 1133 1134 1147 1151 1159 1167 1168 1172 1180 1182 1188 1193 1196 1201 1219 1226 1229 1230 1231 1235 1236 1240 1248 1249 1254 1263 1268 1280 1285 1286 1295 1300 1301 1310 1312 1314 1327 1328 1333 1361 1367 1376 1380 1385 1394 1410 1425 1427 1428 1437 1447 1460 1468 1471 1474 1477 1479 1490 1492 1509 1512 1515 1525 1536 1537 1538 1542 1554 1563 1572 1574 1582 1592 1603 1612 1615 1623 1626 1629 1632 1633 1641 1650 1651 1667 1681 1690 1692 1694 1700 1703 1714 1724 1726 1732 1741 1754 1757 1758 1763 1768 1770 1775 1777 1789 1790 1806 1822 1830 1839 1840 1845 1855 1862 1867 1871 1875 1883 1886 1893 1896 1909 1917 1919 1920 1927 1929 1939 1942 1944 1951 1954 1956 1958 1959 1963 1967 1980 2000 2001 2011 2013 2014 2019 2023 2027 2037 2041 2046 2054 2064 2075 2078 2093 2099 2101 2122 2127 2129 2131 2133 2134 2141 2142 2148 2155 2156 2157 2172 2174 2181 2182 2185 2189 2190 2193 2200 2210 2219 2224 2226 2234 2235 2253 2264 2271 2274 2276 2303 2309 2316 2318 2321 2323 2325 2326 2329 2330 2336
18 45 72 84 90 98 99 106 114 126 131 132 136 144 146 150 152 158 190 191 192 209 216 217 233 244 245 262 273 283 288 289 296 302 313 321 324 325 326 329 336 338 339 345 352 370 377 379 384 386 398 405 418 419 428 429 432 433 434 435 452 477 480 486 494 498 499 504 518 519 523 530 538 539 548 557 560 567 568 576 578 581 597 601 604 611 640 643 646 647 659 669 672 677 682 686 700 701 703 711 714 717 718 724 727 728 737 747 749 752 763 764 766 777 779 783 786 793 794 804 822 831 832 844 853 859 865 869 876 883 887 890 891 909 922 924 929 931 937 942 955 964 973 974 977 987 988 989 991 993 1001 1007 1009 1014 1030 1035 1038 1043 1044 1050 1058 1061 1077 1080 1089 1090 1096 1101 1111 1113 1115 1121 1136 1137 1142 1144 1149 1153 1157 1163 1170 1175 1176 1185 1207 1209 1212 1221 1232 1238 1243 1244 1252 1255 1256 1264 1272 1277 1279 1283 1287 1291 1313 1319 1322 1324 1343 1346 1347 1349 1354 1356 1372 1374 1375 1379 1382 1383 1387 1388 1393 1395 1406 1408 1419 1436 1445 1453 1455 1464 1469 1470 1486 1498 1504 1510 1514 1516 1522 1527 1531 1539 1547 1560 1581 1586 1588 1590 1597 1601 1606 1613 1614 1616 1619 1620 1624 1625 1639 1640 1654 1660 1688 1689 1691 1695 1697 1704 1705 1711 1712 1719 1720 1728 1735 1755 1760 1761 1766 1771 1773 1796 1805 1816 1820 1834 1847 1848 1864 1865 1872 1873 1881 1900 1913 1914 1922 1923 1924 1930 1935 1945 1953 1957 1960 1965 1968 1972 1974 1984 1985 1986 1987 1994 2002 2005 2007 2028 2034 2038 2047 2057 2058 2060 2070 2071 2076 2079 2080 2081 2089 2098 2107 2108 2109 2125 2132 2138 2153 2167 2171 2195 2199 2201 2209 2214 2231 2232 2233 2241 2254 2267 2268 2272 2285 2290 2295 2296 2297 2298 2305 2307 2312 2315 2317 2327 2333
19 23 46 95 97 122 147 177 214 252 275 287 305 315 335 368 369 376 378 382 389 423 426 430 444 476 492 495 501 522 534 535 543 547 561 571 589 653 654 660 666 710 753 770 772 802 818 851 857 860 877 900 905 910 911 926 944 954 976 978 982 994 1023 1062 1169 1174 1178 1194 1213 1241 1257 1282 1289 1307 1337 1350 1352 1366 1386 1389 1398 1418 1422 1439 1446 1456 1457 1461 1549 1551 1566 1580 1635 1644 1659 1662 1706 1716 1717 1733 1745 1762 1767 1774 1804 1813 1819 1824 1833 1854 1870 1874 1901 1932 1938 1970 1976 1990 2017 2030 2032 2039 2044 2055 2092 2135 2137 2169 2208 2221 2236 2238 2247 2255 2256 2263 2280 2291 2313 2320
2339 2340 2341 2342 2343 2344 2345 2346 2347 2348 2349 2350 2351 2352 2353 2354
