3 4 18 21 30 31 35 36 50 51 70 87 112 113 121 132 156 157 167 170 183 187 203 209 212 213 215 216 220 221 241 251 253
16 24 57 59 65 72 73 79 83 107 114 145 149 154 155 164 166 179 204 206 207 219 225 229 248 255
12 37 38 41 43 49 58 64 69 75 84 86 88 94 95 96 106 115 122 126 130 135 137 143 152 158 160 163 169 171 174 195 222 227 228 235 237 240 257
2 9 11 13 14 15 17 19 20 26 27 32 46 55 56 62 68 71 76 77 91 101 104 105 117 119 134 136 139 141 146 147 150 151 180 184 192 194 202 205 208 218 223 224 234 245 250 256 258
1 6 8 22 29 34 45 47 54 60 74 78 90 93 99 102 103 108 110 111 116 118 120 123 142 144 153 159 172 176 178 182 186 200 201 210 230 243 252 259
5 10 23 25 39 42 48 52 61 63 66 67 81 89 98 100 109 124 125 128 129 131 148 168 175 177 185 188 190 191 193 196 211 214 226 231 232 233 236 238 242 246 247 249 260
7 28 33 40 44 53 80 82 85 92 97 127 133 138 140 161 162 165 173 181 189 197 198 199 217 239 244 254
261 262 263 264 265 266 267 268 269 270 271 272 273 274 275 276
