7 13 21 22 37 45 49 51 53 58 59 60 65 72 76 83 91 98 107 114 115 121 122 127 128 140 151 156 158 160 161 178 190 192 194 204 214 223 231 235 241 245 247 251
1 25 27 41 44 63 68 70 71 80 82 84 90 92 94 95 109 113 126 132 145 157 163 165 168 170 175 202 205 218 236 239 248 250 252 260
8 10 14 16 31 35 48 52 54 56 61 66 74 85 102 111 124 125 130 131 134 143 147 148 150 162 164 169 174 198 201 203 207 215 220 224 232 237 242 243 246 255 256 257 258 259
3 5 6 11 12 15 17 26 28 34 36 39 43 47 50 73 79 86 87 88 89 96 100 103 106 110 116 120 123 129 135 142 172 176 177 184 187 191 193 195 199 206 208 210 212 213 217 225 229 230 238 254
2 4 18 20 24 29 33 38 40 42 55 64 77 97 108 117 118 133 136 137 139 141 144 146 152 153 154 166 171 173 180 182 183 189 196 197 200 209 211 222 226 227 228 234 244
9 19 23 30 32 46 57 62 67 69 75 78 81 93 99 101 104 105 112 119 138 149 155 159 167 179 181 185 186 188 216 219 221 233 240 249 253
