1 2 13 18 23 30 31 34 45 46 47 52 53 58 64 74 83
3 4 8 9 12 16 19 26 27 28 37 41 42 60 61 63 70 71 76 81 82 85
5 25 36 40 43 48 59 65 72 79 86
10 14 15 21 24 51 55 57 66 67 69 80
6 7 17 20 22 29 32 33 38 44 50 54 56 68 84
11 35 39 49 62 73 75 77 78 87
