4 5 18 25 29 61 63 64 70 82 85 99 103 104 112 114 120 134 139 141 149 157 163 169 179 180 184 196 213 215 219 221 228 244 250 253 255 257 263 268 271 273 277 282 283 284 285 293 295 296 299 302 307 308 312 326 335 339 340 342 354 358 361 373 377 380 383 385 388 392 397 398 403 404 405 410 412 420 421 425 432 438 440
32 33 37 40 42 47 76 84 88 89 97 105 110 122 142 145 154 162 171 190 194 195 199 201 206 207 218 222 226 233 237 239 242 248 259 264 267 269 275 278 317 318 319 321 322 328 330 332 333 360 369 376 379 384 414 415 423 424 444 445 450
1 6 11 22 23 26 36 48 52 56 73 75 77 81 86 90 94 116 117 118 128 146 150 152 155 165 168 177 182 188 189 208 211 217 220 224 241 246 262 276 290 301 304 306 337 349 356 370 390 393 408 417 419 422 429 446 449
7 8 14 15 19 21 27 28 34 41 43 45 49 54 57 62 66 91 93 98 101 108 109 121 123 127 132 133 151 153 159 175 181 185 192 193 205 214 227 229 231 234 245 247 252 265 292 298 300 305 314 316 320 324 325 327 329 334 336 338 343 348 351 364 367 371 374 378 382 387 394 399 400 406 416 428 430 431 441 443
3 12 13 17 20 24 30 31 35 38 50 55 58 60 68 71 72 74 78 79 80 83 95 96 100 102 106 107 113 119 124 125 126 130 131 136 138 140 144 147 148 156 158 160 164 167 170 183 187 191 200 202 204 209 210 223 235 238 243 251 254 256 260 261 266 270 272 274 279 280 287 294 297 303 310 311 315 323 344 345 347 352 353 357 363 365 372 381 386 389 395 396 401 413 418 427 435 442 447
2 9 10 16 39 44 46 51 53 59 65 67 69 87 92 111 115 129 135 137 143 161 166 172 173 174 176 178 186 197 198 203 212 216 225 230 232 236 240 249 258 281 286 288 289 291 309 313 331 341 346 350 355 359 362 366 368 375 391 402 407 409 411 426 433 434 436 437 439 448
