4	12	16	18	20	21	22	24	25	29	38	40	41	42	43	53	61	70	74	81	87	111	113	122	123	127	129	130	145	149	150	
3	7	9	19	28	30	56	58	63	65	69	85	90	93	97	98	104	119	126	133	135	137	144	
1	2	6	11	13	14	17	27	31	32	33	36	39	45	46	48	51	57	71	72	79	80	89	91	95	99	101	105	106	108	114	115	118	124	125	134	136	140	146	
5	8	15	23	26	34	37	49	50	54	55	59	60	64	66	67	68	75	82	83	84	110	116	117	120	131	132	138	139	142	
10	35	44	47	52	62	73	76	77	78	86	88	92	94	96	100	102	103	107	109	112	121	128	141	143	147	148	
