4 9 15 17 19 20 23 28 30 31 34 43 48 58 59 60 62 63 68 71 72 73 74 76 79 81 83 85 87
2 3 8 10 16 25 27 29 32 36 37 42 54 61 67 69 80 82 86
5 6 7 12 13 14 22 26 33 39 45 47 50 51 53 57 66 75 78 84
1 11 18 21 24 35 38 40 41 44 46 49 52 55 56 64 65 70 77
88 89 90 91 92 93 94 95 96 97 98 99 100 101 102 103
