1 6 8 11 12 15 17 22 31 38 40 41 48 50
2 9 14 20 23 24 25 26 30 33 34 35 45
3 5 7 10 13 19 21 28 29 32 39 42
4 16 18 27 36 37 43 44 46 47 49
51 52 53 54 55 56 57 58
59 60 61 62 63 64 65 66
