3 17 23 34 38 46 58 65 68 75 78 113 114 117 123 128 130 135 136 137 175 180 185 186 187 193 196 197 200 203 216 224 228 251 259 266 271 282 290 294 298 304 305 316 317 323 330 331 337 343 352 365 374 377 401 417 420 424 426 452 453 456 458 459 477 494 495 499 508 514 515 517 521 529 532 535 537 552 558 559 561 565 568 571 573 577 582 592 595 597 622 626 632 635 640 641 649 650 652 671 673 678 679 684 686 688 696 698 705 709 712 715 719 721 727 742 746 770 774 775
5 14 22 25 29 39 48 53 60 63 64 67 69 70 72 73 76 81 84 85 88 101 105 107 116 131 132 134 140 143 155 172 173 179 190 199 204 212 230 238 239 241 254 255 257 268 269 272 281 284 285 309 312 314 315 328 329 333 335 336 344 346 347 351 357 367 380 391 394 397 406 409 414 428 433 435 438 450 451 454 465 479 490 506 510 513 518 520 522 527 546 547 554 589 590 596 603 610 619 621 627 630 631 633 637 648 660 662 675 676 708 730 732 739 752 756 773
7 12 13 24 41 43 74 93 102 115 118 121 122 139 149 154 156 164 165 167 169 174 177 195 218 220 231 243 246 248 262 264 270 275 311 318 319 327 338 341 350 362 390 392 402 404 412 423 430 443 446 455 464 491 502 507 541 542 557 564 570 579 599 602 615 618 620 623 638 656 659 663 668 674 683 685 694 704 706 714 723 753 758 761 772 778
27 47 55 141 163 182 198 202 210 229 250 273 279 280 291 295 302 308 363 368 369 372 407 431 434 441 447 467 480 486 511 524 525 587 591 605 608 614 625 644 645 692 699 713 720 733 741 745 768 769 776
2 10 15 19 20 33 36 37 40 44 45 52 56 61 62 66 86 89 92 94 95 97 103 108 126 127 138 142 150 151 152 161 162 168 183 189 206 208 215 221 223 235 237 252 253 256 258 265 274 278 283 287 289 320 321 325 326 332 353 358 378 384 386 387 388 393 410 415 418 421 427 436 442 444 468 470 472 473 474 481 485 487 505 523 526 528 533 543 548 553 567 572 578 598 607 624 628 634 639 646 669 670 672 680 690 710 711 726 734 736 737 740 750 754 760 765
4 6 51 77 98 99 100 125 133 147 178 181 184 205 207 209 214 217 225 233 288 292 296 307 310 324 339 355 356 360 361 364 366 373 408 413 429 432 462 484 488 496 531 534 576 581 616 629 643 647 651 658 689 697 700 743 757 762 764 766 777 779
9 16 28 30 32 35 50 57 80 82 104 106 110 111 112 129 144 157 191 211 213 222 227 234 236 240 263 267 277 286 297 299 300 301 303 313 340 342 348 376 381 389 395 399 400 405 411 419 422 425 437 445 449 460 461 466 476 478 482 497 498 503 536 544 549 550 562 566 580 583 588 593 601 612 654 665 666 682 687 691 693 701 707 716 722 724 744 747 751 759
1 8 11 18 21 26 31 42 49 54 59 71 79 83 87 90 91 96 109 119 120 124 145 146 148 153 158 159 160 166 170 171 176 188 192 194 201 219 226 232 242 244 245 247 249 260 261 276 293 306 322 334 345 349 354 359 370 371 375 379 382 383 385 396 398 403 416 439 440 448 457 463 469 471 475 483 489 492 493 500 501 504 509 512 516 519 530 538 539 540 545 551 555 556 560 563 569 574 575 584 585 586 594 600 604 606 609 611 613 617 636 642 653 655 657 661 664 667 677 681 695 702 703 717 718 725 728 729 731 735 738 748 749 755 763 767 771
