1 3 5 14 23 25 27 36 40 41 42 44 54 57 58 69 73 74 79 80 81 91 93 97 98 100 108 121 123 134 154 157 173 175 181 187 195 196 197 212 223 224 233 234 236 237 240 243 251 259 266 267 270 277 283 284 297 315 330 332 336 337 340 352 355 357 365 376 386 394 402 411 428 431 439 442 447
19 50 52 65 83 88 118 132 136 150 164 166 176 179 180 185 191 192 210 220 222 230 232 238 248 252 260 262 263 279 285 292 298 299 301 305 310 316 323 328 343 351 353 377 380 384 385 387 405 410 433 436
4 6 9 11 12 13 15 18 20 29 38 39 43 45 55 56 63 64 70 71 72 75 78 82 87 102 103 106 109 113 116 119 120 125 135 142 149 152 155 159 162 165 167 184 188 194 199 204 205 206 207 226 245 246 253 254 257 271 273 275 276 282 302 314 318 331 335 341 345 356 358 363 366 367 368 369 370 373 379 383 393 395 396 399 408 414 415 417 426 434 440 443
8 16 21 28 30 31 35 37 46 48 53 61 62 66 67 76 86 89 90 96 99 114 126 127 137 139 141 148 156 161 169 174 178 182 183 189 190 193 198 202 203 208 213 215 241 242 255 264 274 293 300 304 312 313 317 324 350 361 371 374 378 381 382 388 390 392 397 409 412 416 418 420 422 424 429 445
7 17 26 32 33 47 51 59 68 77 101 110 115 122 124 129 130 140 143 146 151 158 163 172 186 214 216 218 219 225 227 228 235 250 256 261 281 287 290 291 295 303 307 308 319 320 321 322 325 326 329 333 334 347 348 359 360 362 372 398 400 401 403 421 427 432 435 438 441 444 446 448 449 450
2 10 22 24 34 49 60 84 85 92 94 95 104 105 107 111 112 117 128 131 133 138 144 145 147 153 160 168 170 171 177 200 201 209 211 217 221 229 231 239 244 247 249 258 265 268 269 272 278 280 286 288 289 294 296 306 309 311 327 338 339 342 344 346 349 354 364 375 389 391 404 406 407 413 419 423 425 430 437
451 452 453 454 455 456 457 458 459 460 461 462 463 464 465 466
