16 25 61 75 80 107 121 126 166 167 170 186 199 209 221 235 243 260 263 269 296 312 317 322 343 347 350 365 378 382 388 422
6 8 9 24 28 32 45 48 60 63 87 98 102 104 110 117 118 132 133 151 152 161 171 172 174 175 178 194 198 202 210 223 224 232 238 247 250 253 258 262 276 278 283 286 294 298 316 320 328 332 333 335 338 346 349 361 366 372 379 381 389 392 405 408 411 412 416 419 421 428 429 434 442 449
1 3 10 11 13 14 20 29 30 38 44 52 83 88 89 105 106 111 114 120 124 125 137 139 145 163 168 169 176 180 182 185 191 193 208 225 230 233 234 237 239 242 244 248 249 254 272 274 281 282 284 290 303 313 314 326 337 351 354 362 367 374 376 393 395 397 426 441 446
2 4 17 22 26 33 34 37 41 50 53 54 65 70 74 77 81 94 95 96 100 135 141 146 148 149 153 184 192 214 229 231 245 251 255 259 266 285 299 301 302 305 307 310 321 323 325 339 353 355 369 371 375 380 396 398 399 402 433
5 7 12 19 21 27 55 59 64 71 73 76 82 86 91 99 103 113 116 119 128 136 140 144 162 179 183 207 217 220 236 241 246 256 265 270 271 277 279 280 287 289 304 327 329 330 336 340 345 357 360 363 368 384 390 394 406 414 415 431 432 436 443 448
23 31 36 39 40 42 43 46 47 51 67 68 72 84 85 93 97 108 112 115 122 123 129 130 131 134 138 142 143 147 154 157 158 159 164 165 177 181 187 188 189 190 196 197 200 201 203 205 211 212 213 215 216 222 226 228 240 252 261 264 267 273 275 288 293 295 300 309 315 318 324 331 334 348 352 356 358 359 364 370 385 391 404 407 409 410 413 420 423 425 427 438 439 440 445 447
15 18 35 49 56 57 58 62 66 69 78 79 90 92 101 109 127 150 155 156 160 173 195 204 206 218 219 227 257 268 291 292 297 306 308 311 319 341 342 344 373 377 383 386 387 400 401 403 417 418 424 430 435 437 444 450
451 452 453 454 455 456 457 458 459 460 461 462 463 464 465 466
