2 8 13 18 23 30 31 34 45 46 47 53 64 67 83 86
3 5 16 20 25 37 52 56 58 62 65 69 71 79 85
6 7 14 17 22 29 32 33 36 40 43 44 48 50 54 59 60 61 68 84
4 12 21 24 41 42 51 55 57 63 66 70 74 80 81 82
1 9 10 11 15 19 26 27 28 35 38 39 49 72 73 75 76 77 78 87
88 89 90 91 92 93 94 95 96 97 98 99 100 101 102 103
