2 3 9 10 13 15 16 28 30 31 34 36 43
1 6 11 12 14 17 18 19 20 23 25 27 29 32 35 37 40 42 46 47
4 5 7 8 21 22 24 26 33 38 39 41 44 45 48 49 50
51 52 53 54 55 56 57 58
59 60 61 62 63 64 65 66
