6	8	23	31	51	56	63	67	85	95	102	110	112	122	127	131	132	151	154	165	168	173	175	187	188	194	197	205	206	211	212	215	223	253	255	257	264	268	275	289	294	295	304	307	310	319	320	321	326	343	347	349	351	352	356	361	367	372	376	385	397	418	429	430	432	434	
30	38	43	58	62	78	133	147	149	150	155	157	163	167	170	210	227	237	250	266	297	330	342	350	354	366	386	405	413	423	427	431	435	437	444	445	450	
3	12	13	14	18	19	20	22	32	33	47	54	61	92	100	109	115	117	125	126	134	146	158	161	169	176	180	182	184	189	191	193	199	208	209	216	225	230	232	239	243	254	258	260	267	269	273	276	293	300	301	303	311	313	314	317	322	358	369	370	373	375	378	393	400	401	419	422	425	426	440	446	
2	4	5	9	11	15	16	17	26	34	37	41	50	52	53	57	60	65	68	69	70	74	75	79	81	87	93	96	97	103	104	107	113	118	119	120	123	129	135	145	148	152	159	166	171	174	186	192	198	202	207	213	214	218	221	224	229	231	241	245	247	248	249	259	261	265	278	281	283	285	286	287	290	292	298	299	302	305	309	316	324	325	327	333	335	337	338	341	355	360	362	364	371	392	396	398	399	402	404	408	416	424	441	448	
7	21	25	27	39	44	46	49	71	73	76	77	80	82	86	89	90	91	94	98	99	101	105	106	116	121	128	130	136	140	141	144	177	179	183	185	196	204	217	219	220	233	235	244	246	251	252	270	279	280	308	312	315	323	331	332	336	339	340	345	346	357	363	368	379	380	382	384	387	390	394	395	403	406	414	415	428	433	436	442	443	
1	10	24	28	42	45	48	55	64	72	84	108	111	114	124	137	138	139	142	153	156	160	162	172	178	181	190	200	203	228	236	238	256	263	272	274	277	282	306	318	329	365	374	377	381	389	409	410	411	420	438	447	449	
29	35	36	40	59	66	83	88	143	164	195	201	222	226	234	240	242	262	271	284	288	291	296	328	334	344	348	353	359	383	388	391	407	412	417	421	439	
