4 6 9 12 17 24 30 35 39 49 74 75 76 95 102 104 106 107 111 124 135 136 138
11 29 51 56 60 61 79 109 112 117 119
2 3 8 13 14 15 19 22 23 25 27 28 32 34 36 38 42 43 44 45 46 47 50 52 54 55 57 58 59 64 65 71 72 78 80 82 85 88 97 100 126 129 132 139 149
5 10 21 31 33 40 41 48 53 63 66 70 73 81 87 89 92 93 96 99 101 103 108 113 115 118 120 122 125 128 130 131 134 137 140 142 143 144 145 147 148
1 7 16 18 20 26 37 62 67 68 69 77 83 84 86 90 91 94 98 105 110 114 116 121 123 127 133 141 146 150
151 152 153 154 155 156 157 158 159 160 161 162 163 164 165 166
