3 5 8 11 27 31 36 40 48 61 63 76 83 88 91 92 93 96 106 114 129 130 131 133 135 143 144 154 157 160 166 172 175 176 177 185 187 193 217 227 251 253 260 263 265 283 287 290 298 305 314 353 363 367 374 406 408 410 420 459 472 488 492 494 500 506 516 522 526 528 535 566 572 576 588 595 603 608 614 620 624 627 628 632 636 637 655 656 657 664 665 669 679 685 687 688 694 699 716 722 723 753 766 768 773 781 782 792 798 802 806 817 821 835 840 842 843 852 855 857 867 881 895 896 932 933 937 973 977 980 983 989 990 991 996 1019 1027 1032 1041 1044 1049 1060 1062 1063 1065 1066 1070 1072 1079 1081 1083 1091 1098 1100 1102 1111 1121 1162 1173 1179 1196 1198 1199 1216 1220 1230 1244 1252 1256 1278 1279 1289 1298 1299 1306 1308 1317 1324 1329 1334 1347 1349
22 23 32 34 42 44 45 46 49 52 55 62 65 70 73 75 98 107 110 112 116 128 136 139 140 148 150 174 186 189 190 192 203 211 213 220 237 242 245 295 297 299 304 316 322 330 333 336 340 341 344 347 348 349 355 356 358 361 369 372 375 387 392 400 404 409 416 421 423 426 435 436 442 444 445 446 451 454 464 466 473 474 477 480 483 484 498 502 507 513 517 520 524 538 547 554 575 579 585 597 605 615 621 623 631 634 635 643 653 654 658 660 668 680 684 689 693 695 697 705 707 709 714 715 721 729 733 735 743 748 770 771 777 780 787 793 794 795 804 807 810 816 818 822 825 826 833 836 845 846 850 851 853 861 862 876 877 883 884 888 894 915 916 923 925 931 936 959 960 970 979 982 994 1001 1008 1016 1040 1042 1057 1075 1086 1092 1110 1115 1118 1120 1122 1124 1128 1134 1137 1147 1168 1170 1172 1176 1184 1185 1192 1200 1201 1204 1207 1211 1223 1226 1228 1229 1232 1236 1240 1255 1259 1262 1263 1267 1271 1275 1282 1284 1292 1295 1297 1321 1332
6 9 10 19 26 56 59 67 74 78 82 84 87 102 104 113 119 123 137 141 145 146 151 165 168 169 170 171 188 195 202 205 222 226 229 235 241 243 244 254 256 257 262 264 273 282 286 300 301 306 310 313 319 327 331 337 338 339 345 352 354 360 371 378 390 393 407 422 424 431 434 438 456 461 462 463 469 471 478 491 496 499 514 515 521 530 532 533 534 537 553 557 561 565 567 570 574 583 587 592 594 596 598 601 609 612 629 639 641 649 651 652 661 663 671 675 676 681 690 691 700 701 712 720 732 741 747 754 761 778 803 808 815 823 828 829 844 864 868 869 891 892 900 904 910 917 935 938 942 950 952 953 955 958 962 965 968 975 978 984 986 993 1002 1003 1007 1010 1013 1025 1028 1030 1037 1038 1043 1053 1073 1076 1077 1078 1087 1089 1097 1099 1104 1112 1117 1131 1132 1133 1151 1163 1165 1166 1169 1175 1182 1187 1191 1193 1203 1210 1213 1214 1215 1225 1235 1239 1254 1281 1290 1294 1305 1307 1316 1320 1322 1326 1327 1333 1340 1350
2 4 7 14 17 24 25 29 37 39 43 54 57 60 66 68 71 72 77 79 81 86 103 117 120 121 125 127 158 159 162 163 180 183 184 194 198 200 210 214 215 221 224 246 249 259 266 268 269 271 274 276 277 278 284 294 308 311 317 324 325 328 329 342 346 359 362 364 370 376 377 379 382 388 402 411 417 418 428 447 467 479 489 493 501 503 505 508 510 519 525 541 544 546 548 580 586 589 600 602 604 616 617 626 630 642 646 648 662 674 677 696 702 703 708 713 717 719 724 727 744 750 756 759 764 767 774 775 783 784 801 809 814 824 834 837 847 858 866 875 880 886 887 890 893 898 901 902 906 908 911 919 920 921 922 940 944 945 947 949 951 956 964 966 992 995 1004 1005 1014 1021 1023 1024 1029 1034 1035 1039 1046 1047 1048 1050 1051 1055 1056 1074 1095 1096 1113 1114 1127 1129 1130 1136 1139 1143 1150 1153 1160 1164 1167 1171 1180 1181 1183 1195 1197 1209 1212 1219 1222 1224 1231 1237 1238 1246 1251 1257 1261 1268 1272 1274 1291 1304 1310 1312 1315 1323 1330 1335 1337 1342
15 30 53 64 99 105 108 126 152 164 167 191 201 207 208 212 231 236 247 255 296 303 309 315 321 323 332 335 383 385 395 398 403 429 448 449 453 460 465 470 481 540 556 559 560 606 610 618 625 650 672 686 706 730 736 739 745 746 751 779 788 789 812 813 819 827 839 841 848 870 873 885 889 903 907 912 913 914 926 927 928 929 934 941 969 971 972 974 987 997 998 999 1006 1015 1018 1031 1036 1052 1054 1061 1064 1068 1069 1082 1084 1093 1108 1116 1119 1138 1146 1149 1156 1158 1159 1174 1205 1234 1243 1245 1247 1248 1249 1253 1264 1265 1277 1280 1286 1287 1293 1302 1325 1331 1344
1 33 50 69 85 89 124 138 153 156 161 173 178 179 181 182 216 223 228 230 232 234 248 270 279 280 285 288 292 293 318 334 343 350 357 384 386 391 394 396 397 399 412 425 432 440 452 457 476 482 485 486 490 495 497 509 511 512 518 523 527 529 542 543 545 550 551 552 562 563 564 568 571 578 581 591 599 619 638 644 659 666 667 670 682 698 710 711 725 728 734 740 749 755 757 760 765 769 772 785 786 790 800 805 811 820 830 832 838 849 854 859 860 865 872 874 878 882 897 899 909 918 939 943 946 954 961 976 1000 1012 1022 1033 1045 1067 1080 1088 1105 1106 1107 1109 1123 1125 1126 1144 1145 1148 1152 1155 1157 1161 1178 1190 1194 1206 1208 1217 1218 1221 1242 1273 1276 1283 1288 1296 1309 1314 1341 1346 1348
12 13 16 18 20 21 28 35 38 41 47 51 58 80 90 94 95 97 100 101 109 111 115 118 122 132 134 142 147 149 155 196 197 199 204 206 209 218 219 225 233 238 239 240 250 252 258 261 267 272 275 281 289 291 302 307 312 320 326 351 365 366 368 373 380 381 389 401 405 413 414 415 419 427 430 433 437 439 441 443 450 455 458 468 475 487 504 531 536 539 549 555 558 569 573 577 582 584 590 593 607 611 613 622 633 640 645 647 673 678 683 692 704 718 726 731 737 738 742 752 758 762 763 776 791 796 797 799 831 856 863 871 879 905 924 930 948 957 963 967 981 985 988 1009 1011 1017 1020 1026 1058 1059 1071 1085 1090 1094 1101 1103 1135 1140 1141 1142 1154 1177 1186 1188 1189 1202 1227 1233 1241 1250 1258 1260 1266 1269 1270 1285 1300 1301 1303 1311 1313 1318 1319 1328 1336 1338 1339 1343 1345
1351 1352 1353 1354 1355 1356 1357 1358 1359 1360 1361 1362 1363 1364 1365 1366
