7 18 26 29 39 46 47 49 51 60 66 67 71 80 82 85 86 95 98 105 107 111 114 119 127 136 141 143 144 146 150
2 3 8 14 15 17 23 24 25 27 28 30 34 36 38 41 43 44 45 52 54 55 57 59 64 65 74 78 79 81 83 88 97 100 104 117 120 124 129 134 135 139
10 16 20 21 22 31 37 42 48 61 62 68 69 70 90 91 93 94 113 115 118 123 125 131 132 142 145 148
11 19 32 72 76 77 84 109 110 121 133
1 4 5 6 9 12 13 33 35 40 50 53 56 58 63 73 75 87 89 92 96 99 101 102 103 106 108 112 116 122 126 128 130 137 138 140 147 149
