15 17 18 19 28 31 40 42 43 59 65 78 80 91 106 107 108 109 110 113 122 131 133 144 153 167 171 174 175 192 196 199 205 209 221 226 228 230 231 233 240 245 252 262 265 275 281 289 292 299 307 308 312 314 317 318 325 333 334 343 351 352 357 363 368 369 373 374 379 389 392 394 399 400 412 420 423 428 434
4 11 14 21 22 32 38 62 66 69 70 72 98 100 111 112 134 143 149 155 164 166 169 176 179 183 184 191 202 211 212 213 229 232 244 250 254 255 260 269 280 284 285 302 310 322 326 328 336 341 342 355 358 362 366 375 383 387 396 404 406 408 409 410 413 414 429 430 437 440 446 447
2 5 6 9 10 12 23 26 27 36 37 39 44 46 48 57 58 60 63 64 67 73 81 86 90 101 105 114 116 118 120 125 128 132 137 150 152 154 157 158 161 162 165 172 177 182 185 186 208 215 216 217 220 239 241 246 253 261 264 272 276 282 290 293 301 327 329 330 335 338 347 349 350 361 367 370 384 385 386 388 390 391 393 395 398 411 416 419 425 427 433 443 445 448
1 24 25 41 47 49 52 54 55 56 68 71 83 84 87 94 95 96 99 102 103 117 123 124 127 136 138 140 141 142 145 148 159 160 168 170 178 180 187 214 222 223 227 236 242 243 247 257 258 259 263 266 267 270 271 274 279 286 287 291 296 298 304 305 313 316 320 340 344 345 359 365 377 401 402 403 405 407 417 424 431 432 435 436 441 442
7 8 16 20 29 30 34 35 45 50 61 74 75 79 82 85 89 92 93 104 115 119 121 126 129 130 135 147 151 156 181 188 189 194 200 207 210 224 225 234 238 251 256 268 273 277 278 288 294 295 297 300 306 309 311 315 323 324 331 332 339 346 348 353 354 364 372 380 382 415 418 421 422 438 449
3 13 33 51 53 76 77 88 97 139 146 163 173 190 193 195 197 198 201 203 204 206 218 219 235 237 248 249 283 303 319 321 337 356 360 371 376 378 381 397 426 439 444 450
451 452 453 454 455 456 457 458 459 460 461 462 463 464 465 466
