1 2 4 10 14 35 42 51 56 66 69 72 84 90 101 104 124 125 130 131 145 147 150 156 159 180 186 195 198 200 202 205 207 215 217 225 229 236 237 240 257 261 267 268 278 280 283 286 287 290 293 294 303 316 326 329 333 336 337 341 366 371 372 381 387 389 390 392 402 403 406 409 418 432 439 440 458 466 477 483 484 486 488 489 490 494 506 514 515 530 534 538 542 550 553 563 565 568 600 603 609 615 625 637 644 648 649 652 655 656 663 668 669 678 680 684 706 733 736 743 744 753 771 787 789 803 805 814 823 833 835 836 839 847 849 858 860 869 882 892 901 903 905 918 923 934 942 956 964 968 977 987 995 1026 1027 1039 1053 1064 1069 1074 1078 1090 1092 1099 1105 1113 1115 1116 1119 1125 1127 1133 1134 1137 1142 1155 1159 1166 1183 1184 1185 1193 1194 1197 1204 1217 1223 1237 1245 1258 1259 1263 1266 1272 1281 1290 1293 1300 1302 1304 1320 1330 1332 1334 1337 1339 1340 1348
9 13 16 19 25 38 43 46 49 52 53 61 65 73 81 82 85 92 105 107 111 114 118 136 144 167 182 184 185 196 197 203 219 223 230 231 247 249 253 262 263 275 281 298 301 310 313 320 322 324 334 339 340 342 356 361 362 364 373 384 391 400 401 417 425 427 430 433 434 435 442 444 445 446 449 452 460 462 473 476 491 493 498 499 508 511 516 523 531 532 539 546 551 557 573 577 592 599 601 616 617 619 620 636 639 641 642 646 664 666 688 691 694 695 696 702 709 713 717 720 727 728 730 735 737 739 749 758 759 760 773 778 795 806 811 816 818 822 840 842 845 854 862 871 876 877 883 887 888 890 896 897 898 904 910 920 921 924 928 931 938 949 957 967 970 973 974 978 979 991 993 1000 1006 1012 1013 1016 1017 1019 1021 1032 1034 1036 1046 1048 1063 1065 1067 1075 1088 1094 1097 1102 1104 1108 1114 1117 1120 1124 1140 1148 1151 1152 1154 1156 1169 1170 1173 1181 1182 1199 1218 1222 1226 1233 1238 1239 1246 1247 1248 1255 1257 1262 1270 1276 1289 1301 1306 1308 1312 1316 1325 1328 1333 1336 1342
24 30 34 45 47 50 63 70 74 77 80 96 97 102 117 121 126 132 133 140 146 151 152 160 161 168 169 179 187 192 209 212 214 220 250 251 252 256 272 274 277 284 295 297 306 317 319 323 330 338 348 359 365 369 374 382 385 386 393 415 424 436 450 465 478 479 480 502 519 533 535 540 545 554 556 558 570 572 574 576 579 585 588 595 608 610 614 622 623 626 630 631 633 640 653 657 661 662 676 677 679 681 687 708 718 732 740 742 745 757 761 767 774 779 783 785 797 802 820 838 841 843 863 864 866 874 927 932 933 936 939 944 950 952 954 960 962 972 975 982 992 998 999 1005 1007 1008 1022 1028 1035 1054 1057 1060 1061 1066 1068 1086 1091 1101 1106 1131 1144 1149 1162 1164 1174 1187 1189 1202 1203 1209 1210 1211 1221 1225 1227 1228 1234 1240 1250 1252 1261 1269 1271 1274 1277 1279 1280 1282 1291 1296 1298 1303 1319 1321 1326 1341 1350
15 20 22 23 26 29 31 32 36 39 54 55 58 62 64 68 71 75 87 108 109 112 115 122 128 129 137 142 149 153 154 155 158 162 172 173 174 178 183 189 206 210 232 233 235 238 244 246 259 264 279 300 302 308 312 321 325 327 335 346 350 353 358 367 370 376 378 379 380 383 388 395 405 407 410 414 416 423 426 429 438 451 453 455 456 457 461 463 464 468 469 470 474 482 497 503 509 517 518 521 524 526 527 528 537 552 555 564 566 567 578 581 586 587 589 590 594 606 611 621 624 628 629 634 638 647 658 659 660 667 674 689 697 698 699 701 710 714 716 719 721 722 726 731 746 754 755 763 765 772 781 790 793 796 801 809 813 815 819 824 828 830 832 844 848 857 859 872 873 881 884 885 891 902 911 912 914 915 919 926 929 930 935 937 943 947 948 951 958 969 976 997 1001 1025 1033 1043 1045 1050 1051 1056 1059 1062 1073 1076 1079 1081 1082 1083 1085 1087 1098 1103 1107 1109 1112 1121 1135 1136 1138 1139 1143 1153 1157 1158 1161 1165 1167 1168 1180 1186 1188 1191 1192 1200 1205 1206 1208 1214 1229 1236 1241 1244 1251 1292 1314 1318 1329 1338 1346 1347 1349
3 7 17 33 40 41 48 57 59 60 67 76 78 86 91 94 95 98 99 106 116 119 120 123 127 135 138 139 143 157 163 164 170 175 176 188 190 194 199 216 222 226 241 242 245 248 254 258 260 269 271 273 282 285 289 292 296 311 314 315 345 347 349 352 354 357 368 377 397 399 412 413 419 428 431 447 454 459 471 472 475 481 485 496 543 544 547 548 559 562 569 571 580 582 591 596 597 602 605 618 643 645 654 670 671 675 683 686 693 705 707 712 715 725 729 734 738 741 748 750 751 766 769 775 780 784 786 788 791 792 794 800 804 808 810 817 834 837 851 852 856 861 865 868 879 880 886 893 894 906 907 908 909 913 916 917 922 941 945 953 965 980 984 985 986 990 996 1002 1009 1010 1014 1015 1020 1029 1030 1031 1037 1070 1072 1080 1084 1089 1111 1123 1128 1129 1132 1141 1145 1146 1147 1163 1171 1172 1175 1176 1179 1190 1195 1215 1216 1220 1224 1230 1231 1242 1243 1249 1253 1254 1267 1273 1278 1285 1286 1299 1313 1315 1322 1323 1327 1331 1343 1344 1345
5 6 8 11 12 18 21 27 28 37 44 79 83 88 89 93 100 103 110 113 134 141 148 165 166 171 177 181 191 193 201 204 208 211 213 218 221 224 227 228 234 239 243 255 265 266 270 276 288 291 299 304 305 307 309 318 328 331 332 343 344 351 355 360 363 375 394 396 398 404 408 411 420 421 422 437 441 443 448 467 487 492 495 500 501 504 505 507 510 512 513 520 522 525 529 536 541 549 560 561 575 583 584 593 598 604 607 612 613 627 632 635 650 651 665 672 673 682 685 690 692 700 703 704 711 723 724 747 752 756 762 764 768 770 776 777 782 798 799 807 812 821 825 826 827 829 831 846 850 853 855 867 870 875 878 889 895 899 900 925 940 946 955 959 961 963 966 971 981 983 988 989 994 1003 1004 1011 1018 1023 1024 1038 1040 1041 1042 1044 1047 1049 1052 1055 1058 1071 1077 1093 1095 1096 1100 1110 1118 1122 1126 1130 1150 1160 1177 1178 1196 1198 1201 1207 1212 1213 1219 1232 1235 1256 1260 1264 1265 1268 1275 1283 1284 1287 1288 1294 1295 1297 1305 1307 1309 1310 1311 1317 1324 1335
