8 15 25 36 38 54 63 64 75 82 97 101 103 119 121 138 148 151 153 156 165 167 191 194 205 211 213 218 219 222 225 231 246 252 261 267 269 288 297 327 333 336 344 354 360 366 382 398 429 445 449 456 459 504 519 533 536 548 562 563 566 570 572 584 585 603 607 613 658 664 667 670 698 703 722 731 733 742 749 759 761 763 777 778 783 808 816 838 841 859 870 879 880 886 889 890 894 895 901 912 917 920 928 929 932 935 940 944 953 983 986 987 991 998 1017 1021 1023 1025 1034 1045 1055 1056 1071 1073 1074 1085 1102 1116 1118 1123 1140 1154 1166 1168 1170 1176 1177 1178 1181 1183 1186 1188 1208 1211 1221 1225 1238 1265 1272 1277 1302 1310 1324 1337 1339 1354 1363 1366 1381 1390 1398 1399 1405 1408 1416 1419 1431 1432 1460 1462 1468 1494 1505 1514 1516 1527 1546 1552 1581 1596 1602 1605 1608 1609 1617 1619 1620 1623 1637 1638 1647 1649 1657 1666 1670 1672 1677 1685 1687 1688 1716 1725 1733 1742 1775 1790 1800 1805 1807 1816 1825 1830 1833 1837 1841 1842 1847 1862 1863 1881 1884 1886 1888 1891 1899 1901 1906 1914 1915 1928 1939 1953 1954 1964 1975 1977 1989 1992 2001 2007 2012 2022 2023 2025 2031 2033 2039 2059 2066 2069 2070 2073 2076 2078 2093 2097 2098 2103 2104 2106 2107 2114 2118 2128 2144 2153 2173 2182 2185 2199 2200 2212 2225 2247 2249 2262 2277 2279 2301 2310 2316 2326 2338
10 11 18 29 31 37 43 56 60 71 77 84 89 92 99 105 115 124 139 140 150 157 158 170 173 181 202 203 212 224 228 235 237 242 249 253 264 266 268 270 286 287 298 299 301 312 314 318 331 335 339 340 349 362 363 369 377 378 381 386 390 409 411 417 420 431 436 439 458 471 475 476 485 493 505 506 508 511 512 513 520 522 523 530 560 567 575 577 595 608 609 615 616 617 623 635 638 639 644 645 646 649 662 688 695 699 700 707 711 720 724 734 738 741 746 751 752 753 754 769 798 801 805 812 815 817 820 822 840 849 850 853 855 857 866 871 878 881 882 883 884 887 905 907 908 919 930 931 946 954 958 960 963 976 977 985 988 995 999 1015 1018 1032 1047 1048 1065 1066 1072 1076 1090 1095 1097 1103 1112 1134 1144 1146 1149 1162 1167 1169 1173 1175 1179 1184 1187 1190 1196 1209 1210 1213 1219 1220 1226 1227 1242 1247 1259 1263 1267 1292 1293 1299 1317 1321 1325 1345 1346 1349 1351 1356 1370 1372 1387 1391 1397 1404 1406 1424 1426 1427 1441 1442 1445 1457 1469 1477 1478 1481 1482 1483 1488 1489 1491 1495 1501 1502 1508 1513 1529 1536 1539 1542 1547 1549 1556 1559 1564 1575 1579 1582 1583 1588 1599 1601 1604 1614 1615 1628 1631 1635 1664 1669 1679 1693 1708 1710 1714 1726 1744 1746 1747 1758 1760 1777 1780 1782 1783 1792 1795 1798 1801 1802 1813 1815 1819 1828 1835 1836 1845 1849 1866 1878 1882 1890 1897 1904 1908 1909 1910 1927 1932 1936 1941 1950 1955 1956 1971 1976 1980 1981 1998 2003 2017 2028 2038 2040 2041 2047 2050 2061 2067 2068 2083 2084 2085 2087 2092 2116 2123 2129 2137 2147 2149 2150 2157 2158 2161 2163 2165 2168 2176 2189 2194 2198 2210 2224 2226 2236 2245 2252 2254 2259 2268 2281 2283 2285 2288 2313 2314 2329 2337
13 23 33 53 81 88 94 111 135 169 178 182 183 193 201 206 210 220 259 272 295 315 328 334 337 343 347 351 353 361 406 416 437 450 455 468 473 474 478 483 487 491 499 503 532 546 555 581 583 599 600 605 611 621 626 632 633 640 647 661 678 684 696 697 712 713 729 730 737 743 745 748 760 762 772 775 781 785 793 802 819 824 827 828 833 836 842 851 858 864 892 897 902 911 914 922 926 947 949 957 973 990 992 1002 1004 1012 1013 1019 1022 1026 1041 1046 1049 1051 1063 1079 1083 1086 1087 1089 1092 1093 1106 1119 1124 1138 1148 1155 1159 1163 1199 1202 1203 1215 1217 1245 1248 1255 1257 1258 1276 1284 1295 1303 1308 1319 1320 1329 1334 1342 1348 1350 1358 1362 1368 1376 1392 1401 1411 1418 1420 1423 1425 1429 1444 1465 1476 1498 1506 1511 1515 1523 1525 1535 1554 1577 1580 1591 1610 1625 1632 1641 1646 1648 1650 1656 1658 1659 1667 1676 1684 1691 1701 1706 1722 1730 1731 1734 1737 1739 1741 1743 1745 1769 1776 1779 1808 1810 1812 1814 1838 1852 1857 1858 1860 1867 1869 1870 1879 1907 1911 1918 1921 1930 1938 1960 1961 1963 1979 1988 1997 2000 2002 2014 2018 2024 2026 2035 2036 2052 2056 2057 2062 2079 2119 2122 2136 2154 2159 2162 2186 2195 2197 2213 2214 2215 2231 2237 2241 2261 2270 2276 2278 2282 2291 2292 2305 2315 2317 2321 2327 2330 2335
16 17 27 40 45 46 49 51 65 66 68 70 78 80 90 93 96 108 110 117 120 129 133 134 136 137 141 143 154 161 162 166 174 175 176 179 186 189 200 204 216 217 229 233 234 239 247 254 262 263 274 279 281 291 300 306 316 320 321 322 324 325 326 372 375 383 385 387 389 391 395 403 410 413 422 424 427 438 441 442 454 463 466 470 484 486 488 495 514 526 542 547 550 551 557 564 571 579 588 590 591 593 606 620 631 648 652 660 666 681 704 706 708 714 732 735 747 755 758 764 767 770 780 787 792 796 806 814 821 825 834 861 868 903 916 921 923 924 938 962 964 970 971 972 981 989 996 997 1001 1003 1005 1009 1010 1014 1024 1033 1039 1040 1044 1050 1052 1054 1070 1075 1084 1088 1108 1117 1121 1125 1131 1142 1145 1147 1150 1151 1152 1153 1158 1172 1185 1197 1204 1205 1206 1218 1222 1224 1233 1235 1236 1237 1244 1251 1252 1262 1274 1283 1290 1312 1315 1322 1328 1332 1333 1340 1344 1364 1365 1373 1374 1382 1400 1407 1410 1421 1428 1433 1436 1440 1443 1451 1452 1453 1459 1461 1470 1485 1496 1500 1510 1519 1526 1537 1551 1553 1557 1561 1567 1568 1573 1585 1607 1612 1613 1618 1642 1643 1645 1653 1675 1689 1694 1704 1712 1713 1721 1732 1748 1753 1757 1759 1770 1773 1784 1788 1818 1821 1824 1848 1856 1859 1872 1873 1874 1877 1902 1905 1919 1920 1924 1926 1929 1946 1949 1959 1965 1968 1970 1978 1985 1990 1993 2015 2021 2037 2045 2048 2053 2064 2065 2074 2081 2089 2096 2108 2127 2146 2151 2155 2156 2164 2170 2171 2177 2179 2187 2192 2202 2205 2206 2216 2218 2228 2246 2250 2251 2265 2267 2294 2298 2299 2320
2 19 20 21 24 41 48 57 58 67 72 83 95 109 125 126 127 128 131 152 155 160 164 168 172 185 187 197 230 240 244 256 257 265 285 289 292 304 305 310 313 319 330 332 342 346 355 357 365 371 392 399 404 414 423 426 430 433 447 453 462 469 479 481 482 489 492 500 507 509 516 524 527 538 539 540 541 559 580 587 597 598 610 622 628 629 634 655 665 679 680 685 689 690 693 705 715 721 728 736 739 740 765 773 774 786 788 790 795 807 813 829 839 843 844 845 847 862 873 891 906 918 934 939 941 942 948 951 959 969 979 984 1000 1006 1008 1036 1037 1042 1053 1057 1064 1067 1077 1100 1101 1104 1111 1113 1114 1115 1122 1126 1132 1135 1137 1143 1161 1164 1165 1180 1195 1200 1212 1230 1241 1243 1250 1254 1256 1260 1261 1281 1282 1285 1286 1294 1301 1304 1309 1327 1331 1347 1352 1353 1357 1361 1371 1375 1379 1380 1383 1384 1386 1389 1394 1415 1430 1437 1446 1455 1463 1464 1471 1473 1480 1484 1492 1493 1504 1512 1518 1521 1524 1530 1532 1534 1541 1543 1544 1545 1550 1555 1565 1584 1589 1594 1595 1597 1639 1651 1654 1661 1671 1673 1674 1680 1681 1696 1698 1699 1707 1711 1718 1735 1736 1750 1764 1781 1785 1791 1793 1797 1803 1809 1811 1817 1820 1826 1829 1844 1868 1876 1885 1889 1892 1893 1894 1895 1898 1923 1925 1937 1943 1945 1947 1951 1958 1962 1987 1991 2011 2020 2027 2029 2030 2032 2043 2046 2058 2071 2072 2075 2082 2090 2095 2105 2109 2110 2115 2117 2126 2130 2145 2148 2169 2172 2175 2183 2190 2191 2193 2196 2203 2211 2222 2223 2233 2234 2238 2242 2243 2257 2274 2287 2290 2293 2297 2306 2312 2322 2323 2324 2331 2333
9 12 26 34 35 39 44 47 59 69 74 79 85 91 98 112 116 122 123 130 132 147 180 184 190 195 208 214 223 241 243 260 271 275 278 293 294 303 307 308 323 341 352 358 359 364 370 379 388 393 394 397 402 405 425 428 432 434 435 440 446 451 460 465 467 472 497 498 502 517 518 529 534 537 545 549 553 554 556 558 561 565 569 574 578 582 586 589 592 594 596 602 614 618 627 636 637 642 653 654 656 659 668 671 676 683 686 692 694 701 709 710 718 723 727 744 750 756 766 771 779 782 797 800 803 809 830 832 835 846 856 860 863 865 869 872 874 875 877 888 893 896 900 904 910 913 927 952 955 956 965 968 974 994 1007 1020 1028 1030 1031 1035 1043 1058 1060 1062 1068 1069 1078 1081 1094 1098 1109 1110 1120 1127 1128 1129 1130 1136 1139 1141 1156 1157 1182 1191 1192 1228 1232 1239 1240 1246 1249 1253 1269 1270 1275 1278 1287 1288 1289 1291 1305 1316 1318 1323 1338 1341 1343 1359 1385 1393 1395 1396 1402 1403 1409 1412 1413 1417 1422 1434 1438 1448 1458 1466 1472 1475 1486 1487 1490 1507 1517 1522 1528 1531 1560 1562 1563 1569 1571 1587 1592 1593 1598 1606 1611 1621 1624 1626 1627 1630 1634 1640 1644 1663 1665 1678 1682 1683 1686 1690 1692 1695 1702 1705 1715 1720 1724 1728 1729 1740 1752 1754 1755 1761 1763 1765 1768 1772 1774 1778 1786 1787 1794 1806 1827 1834 1839 1840 1843 1850 1851 1853 1854 1855 1861 1864 1865 1871 1896 1900 1912 1916 1917 1931 1933 1934 1940 1944 1948 1957 1967 1969 1973 1974 1983 1986 1994 1995 1996 2006 2008 2009 2019 2034 2042 2044 2049 2051 2054 2077 2086 2088 2094 2100 2101 2113 2120 2124 2132 2134 2135 2138 2140 2142 2160 2167 2174 2178 2180 2204 2207 2209 2221 2227 2229 2232 2235 2239 2240 2244 2248 2253 2255 2256 2258 2260 2263 2264 2271 2272 2275 2280 2284 2289 2295 2309 2319
1 3 4 5 6 7 14 22 28 30 32 42 50 52 55 61 62 73 76 86 87 100 102 104 106 107 113 114 118 142 144 145 146 149 159 163 171 177 188 192 196 198 199 207 209 215 221 226 227 232 236 238 245 248 250 251 255 258 273 276 277 280 282 283 284 290 296 302 309 311 317 329 338 345 348 350 356 367 368 373 374 376 380 384 396 400 401 407 408 412 415 418 419 421 443 444 448 452 457 461 464 477 480 490 494 496 501 510 515 521 525 528 531 535 543 544 552 568 573 576 601 604 612 619 624 625 630 641 643 650 651 657 663 669 672 673 674 675 677 682 687 691 702 716 717 719 725 726 757 768 776 784 789 791 794 799 804 810 811 818 823 826 831 837 848 852 854 867 876 885 898 899 909 915 925 933 936 937 943 945 950 961 966 967 975 978 980 982 993 1011 1016 1027 1029 1038 1059 1061 1080 1082 1091 1096 1099 1105 1107 1133 1160 1171 1174 1189 1193 1194 1198 1201 1207 1214 1216 1223 1229 1231 1234 1264 1266 1268 1271 1273 1279 1280 1296 1297 1298 1300 1306 1307 1311 1313 1314 1326 1330 1335 1336 1355 1360 1367 1369 1377 1378 1388 1414 1435 1439 1447 1449 1450 1454 1456 1467 1474 1479 1497 1499 1503 1509 1520 1533 1538 1540 1548 1558 1566 1570 1572 1574 1576 1578 1586 1590 1600 1603 1616 1622 1629 1633 1636 1652 1655 1660 1662 1668 1697 1700 1703 1709 1717 1719 1723 1727 1738 1749 1751 1756 1762 1766 1767 1771 1789 1796 1799 1804 1822 1823 1831 1832 1846 1875 1880 1883 1887 1903 1913 1922 1935 1942 1952 1966 1972 1982 1984 1999 2004 2005 2010 2013 2016 2055 2060 2063 2080 2091 2099 2102 2111 2112 2121 2125 2131 2133 2139 2141 2143 2152 2166 2181 2184 2188 2201 2208 2217 2219 2220 2230 2266 2269 2273 2286 2296 2300 2302 2303 2304 2307 2308 2311 2318 2325 2328 2332 2334 2336
