2	4	5	14	38	41	48	64	78	81	82	84	87	88	94	95	117	123	130	132	137	140	144	145	155	157	182	185	197	220	226	228	236	240	244	251	259	288	292	294	296	301	306	309	315	337	338	346	352	363	365	368	374	376	382	383	385	394	404	405	408	414	419	424	425	428	429	430	436	
7	24	26	30	32	40	44	46	47	49	51	53	59	70	72	77	79	80	83	89	91	101	109	115	118	121	122	124	131	133	142	146	151	154	162	163	164	169	177	180	186	195	201	202	208	214	218	224	225	227	233	234	237	239	250	256	264	268	287	291	295	302	303	304	322	324	325	327	332	340	355	359	362	366	372	381	388	400	401	402	403	410	411	412	417	418	421	423	427	434	435	444	445	448	449	
36	52	74	98	103	106	112	134	139	143	147	184	189	207	210	212	219	223	230	232	242	247	248	258	276	277	278	285	290	298	310	316	321	323	336	339	341	343	353	354	360	371	390	396	398	431	438	446	450	
10	22	25	28	42	54	58	66	67	69	71	85	93	97	100	107	111	116	125	153	156	168	170	171	173	174	175	176	187	193	200	209	213	217	221	229	238	243	245	246	252	253	261	262	263	265	269	270	275	280	284	299	307	311	313	320	345	348	349	393	397	399	407	409	413	420	433	437	439	441	442	443	
6	8	16	17	19	21	23	31	34	35	37	39	61	62	73	76	86	90	96	99	104	114	126	127	129	138	141	148	149	159	160	166	178	183	190	192	196	198	203	204	215	222	231	235	241	249	260	266	267	271	272	274	283	286	289	293	297	300	305	312	317	318	319	328	334	344	347	350	351	356	361	375	377	378	380	384	389	392	422	426	447	
1	3	9	11	12	13	15	18	20	27	29	33	43	45	50	55	56	57	60	63	65	68	75	92	102	105	108	110	113	119	120	128	135	136	150	152	158	161	165	167	172	179	181	188	191	194	199	205	206	211	216	254	255	257	273	279	281	282	308	314	326	329	330	331	333	335	342	357	358	364	367	369	370	373	379	386	387	391	395	406	415	416	432	440	
